a|a, to
abajo|down, below, downstairs
abandonar|to abandon
abandonado/a|abandoned
abandono|abandonment
abanico|fan
abanicar|to fan
abaratar|to lower the price of
abarcar|to cover
abarrotes|groceries, packings
abastecer|to supply
abastecimiento|supplying
abasto|supply
abatir|to knock down
abatirse|to get depressed
abatido/a|dejected
abatimiento|discouragement
abdicar|to abdicate
abdicación\ciones|abdication
abdomen|abdomen
abdominal|abdominal
abecedario|alphabet
abedul|birch
abeja|bee
aberración\ciones|aberration
abertura|opening
abierto/a|open
abismo|abyss
abismal|enormous
ablandar|to soften
ablandarse|to soften
abnegarse|to deny oneself
abnegado/a|self-sacrificing
abnegación\ciones|self-denial
abochornar|to embarass
abochornarse|to get embarassed
abofetear|to slap
abogado/a|lawyer
abogacía|legal profession
abogar|to defend, plead of
abolir|to abolish
abolición\ciones|abolition
abollar|to dent
abolladura|dent
abominar|to detest
abominable|abominable
abominación\ciones|abomination
abonar|to pay
abonado/a|subscriber
abono|payment, fertiñizer
abordar|to tackle, accost, board
aborigen\rígenes|aborigine
aborrecible|hateful
abortar|to abort
aborto|abortion
abotonar|to button
abrazar|to embrace
abrazo|hug
abrebotellas|bottle opener
abrelatas|can opener
abreviar|to shorten
abreviación\ciones|abbreviation
abreviatura|abbreviation
abridor|opener
abrigar|to shelter, wrap up
abrigarse|to take shelter
abrigado/a|sheltered
abrigo|coat, shelter
abril|april
abrillantar|to polish, shine
abrir|to open, unlock
abrochar|to fasten, to button
abrocharse|to fasten oneself
abrumar|to crush, to overwhelm
abrumador/dora|overwhelming
absoluto/a|absolute
absolutamente|absolutely
absolver|to absolve
absorber|to absorb
absorbente|absorbent
absorción\ciones|absorption
absorto/a|absorbed, engrossed
abstenerse|abstain, refrain
abstención\ciones|abstention
abstinencia|abstinence
abstracción\ciones|abstraction
abstracto/a|abstract
abstraer|to abstract
abstraído\da|abstracted, preoccupied
absurdo/a|absurd
abundancia|abundance
abundante|abundant
aburrir|to bore (as in yawn)
aburrirse|to become bored
aburrido/a|boring
aburrimiento|boredom
abusar|to abuse
abusivo/a|abusive
acabar|to finish
acabado/a|finished
academia|academy
académico/a|academic
acalorar|to warm up, to stir up
acalorarse|to get worked up
acalorado/a|heated
acampar|to camp
acantilado|cliff
acariciar|to caress
acarrear|to carry
acaso|perhaps, maybe
acaudalado/a|wealthy, accumulated
acceder|to agree
acceso|access
accesible|accessible
accesorio|accessory
accidentado/a|turbulent, rough, victim
accidental|accidental
accidente|accident
acción\ciones|action
accionar|to drive, to activate
accionista|shareholder
acechar|to watch, stalk
aceite|oil
aceitar|to oil
aceitoso/a|oily
aceituna|olive
acelerar|to accelerate
acelga|chard
acentuar|to accentuate
acento|accent, emphasis
aceptar|to accept
aceptable|acceptable
aceptación\ciones|acceptance
acera|sidewalk
acero|steel
acertado/a|accurate
acertijo|riddle
acetona|acetone
achicar|to drain, to make smaller
ácido/a|acid
acidez\deces|acidity
acierto|correct
aclamar|to acclaim
aclamación\ciones|acclaim
aclarar|to clarify
aclaración\ciones|explanation
aclaratorio/ria|explanatory
aclimatar|to acclimate
aclimatarse|to become aclimated
aclimatación\ciones|acclimatization
acné|acne
acobadar|to intimidate
acobardarse|to become frightened
acoger|to welcome
acogerse|to take refuge
acogedor/dora|cosy
acogida|welcome
acolchar|to pad
acometer|to undertake, to attack
acomodar|to adjust
acomodarse|to settle in
acomodado/a|accommodated, well to do
acompañar|to accompany
acompañamiento|accompaniment
acompañante|companion
acondicionar|to prepare, to equip
acondicionado/a|equipped
acongojarse|to get upset
aconsejar|to advise
aconsejable|advisable
acontecer|to occur
acontecimiento|event
acordar|to decide
acordarse|to remember
acorde|agreed
acordeón\deones|accordion
acortar|to shorten
acortarse|to get shorter
acosar|to harass
acoso|harassment
acostar|to lay down
acostarse|to lie down, go to bed
acostumbrarse|to get used to
acostumbrado/a|accustomed, usual
acrecentar|to increase
acrecentamiento|increase, growth
acreditar|to accredit
acreditarse|to prove oneself
acreditado/a|accredited
acreedor/dora|creditor, whorty
acribillar|to riddle
acrílico|acrylic
acrobacia|acrobatics
acróbata|acrobat
acrobático/a|acrobatic
acta|act
actitud|attitude
activar|to activate
actividad|activity
activo/a|assets
acto|act
actor|actor
actriz\trices|actress
actual|present
actualidad|the present time
actualizar|to update
actualización\ciones|update
actualmente|at present, nowadays
actuar|to act
acuarela|watercolor
acuario|aquarium
acuático/a|aquatic
acuchillar|to stab, knife
acudir|to go, come
acueducto|aqueduct
acuerdo|agreement
acumular|to accumulate
acumularse|to pile up
acumulación\ciones|accumulation
acumulador|storage battery
acumulativo/a|cumulative
acupuntura|acupuncture
acurrucarse|to curl up, nestle
acusar|to accuse
acusación\ciones|accusation
acusado/a|defendant
acústica|acoustics
acústico/a|acoustics
adagio|adage, proverb
adaptar|to adapt
adaptarse|to adapt
adaptable|adaptable
adaptación\ciones|adaptation
adaptador|adapter
adecuar|to adapt
adecuarse|to be appropriate
adecuado/a|adapted
adelantar|to advance
adelantarse|to go ahead
adelantado/a|advanced
adelante|ahead
adelgazar|to become thin
ademán\manes|gesture
además|in addition, besides, furthermore
adentro|inside
adentrarse|to go into, get inside of
adepto/a|follower
aderezar|to decorate
aderezo|dressing
adeudar|to owe
adherirse|to adhere
adherencia|adhesion
adhesión\siones|adhesion
adhesivo/a|adhesive
adición\ciones|addition
adicional|additional
adicto/a|addict
adiestrar|to train
adinerado/a|wealthy
adiós|good bye
aditivo|additive
adivinar|to guess, foretell
adivinación\ciones|guessing, prediction
adivinanza|riddle
adivino/a|fortune teller
adjetivo/a|adjective
adjudicar|to award
adjudicarse|to appropriate
adjudicación\ciones|awarding
adjuntar|to enclose
adjunto/a|associate, enclosed
administración\ciones|administration, management
administrador/dora|administrator,manager
administrar|to administer, manage
administrativo/a|administrative
admirar|to admire
admirable|admirable
admiración\ciones|admiration
admirador/dora|admirer
admitir|to admit
admisión\siones|admission
adn|dna
adobe|adobe
adobo|marinade
adoctrinar|to indoctrinate
adoctrinamiento|indoctrination
adolecer|to suffer
adolescente|adolescent
adolescencia|adolescence
adonde|where
adónde|where
adoptar|to adopt
adopción\ciones|adoption
adoptivo/a|adoptive
adorar|to adore, worship
adorable|adorable
adoración\ciones|adoration, worship
adormecer|to make sleepy
adormecerse|to doze off
adormecimiento|drowsiness
adornar|to adorn, decorate
adorno|ornament,decoration
adquirir|to acquire
adquisición\ciones|acquisition
adrede|intentionally, on purpose
aduana|customs
aduanero/a|customs officer
aducir|to cite, put forward
adueñarse|to take possession
adular|to flatter
adulación\ciones|flattery
adulador/dora|flatterer
adulterar|to adulterate
adulterio|adultery
adúltero/a|adulterer
adulto/a|adult
advenimiento|advent, arrival
adverbio|adverb
adverbial|adverbial
adversario/ria|adversary
adverso/a|adverse
adversidad|adversity
adyacente|adjacent
aéreo/rea|aerial
aerobic|aerobics
aerodinámico/a|aerodynamic
aeródromo|airfield
aerolínea|airline
aeromozo/a|flight attendant, steward
aeronave|airship
aeropuerto|airport
aerosol|aerosol, spray
afán\afanes|eagerness, effort
afanarse|to toil
afanosamente|laboriously
afanoso/a|laborious, eager
afección\ciones|affection
afectar|to affect
afectación\ciones|affectation
afectado/a|affected
afectivo/a|affective
afecto|affection
afectuoso/a|affectionate
afeitar|to shave
afeitarse|to shave
afeitada|shave
afeminado/a|made effeminate
aferrarse|to cling
afianzar|to strengthen
afianzarse|to become established
afiche|poster
afición\ciones|hobby, penchant
aficionado/a|fan
aficionarse|to become interested
afilar|to sharpen
afilado/a|sharp
afilador|knifegrinder, sharpener
afiliación\ciones|affiliation
afiliado/a|affiliated
afín|compatible
afin\afines|compatible
afinidad|affinity
afinar|to tune, refine
afirmar|to affirm
afirmación\ciones|affirmation
afirmativo/a|affirmative
afligir|to afflict, distress
afligirse|to grieve
aflición\ciones|affliction, sorrow
afligido/a|sorrowful
aflojar|to loosen, slacken
afloramiento|outcrop
afluencia|affluence
afluente|affluent
afortunado/a|lucky, fortunate
afortunadamente|fortunately, luckily
afrentar|to insult
afrenta|insult
africano/a|african
afrontar|to confront
afuera|outside
agachar|to bend, lower
agacharse|to crouch
agalla|grill
agarrar|to grasp, catch
agarrarse|to hold on
agarradera|handle
agarrado/a|stingy
agarre|take hold, grip
agasajar|to entertain, fete
agasajo|entertainment, lavish attention
agencia|agency
agente|agent, officer
agenda|agenda
ágil|agile
agilidad|agility
agitar|to shake, agitate
agitarse|to be shaken, toss about
agitación\ciones|agitation
agitado/a|agitated, excited, shaken
aglomerar|to amass
aglomerarse|to crowd together
agnóstico/a|agnostic
agobiado/a|weary
agobiante|oppressing
agonizar|to be dying
agonía|agony, death
agonizante|dying
agosto|august
agotar|to exhaust, deplete
agotarse|to run out, get tired
agotado/a|exhausted
agotador/dora|exhausting
agotamiento|exhaustion
agraciado/a|attractive
agradar|to be pleasing
agradable|pleasant
agrado|pleasure
agradecer|to be thankful
agradecido/a|grateful
agradecimiento|gratefulness
agrandar|to enlarge
agrandarse|to grow larger
agrario/ria|agrarian, agricultural
agravar|to make heavier
agravarse|to get worse
agraviar|to offend, insult
agredir|to attack
agregar|to add, attach
agresión\siones|aggression
agresividad|aggressiveness
agresivo/a|aggressive
agresor/sora|aggressor
agriar|to sour
agriarse|to turn sour
agrícola|agricultural
agricultura|agriculture, farming
agricultor/tora|farmer
agridulce|bittersweet
agrietar|to crack
agrio/agria|sour
agrupar|to group
agruparse|to form a group
agrupación\ciones|group, association
agrupamiento|grouping
agua|water
aguacate|avocado
aguado/a|watery
aguantar|to hold, bear
aguantarse|to resign oneself
aguardar|to await
aguardiente|brandy
aguarrás|turpintine
agudo/a|acute, sharp
agudeza|sharpness
águila|eagle
aguja|needle
agujero|hole
agujeta|shoelace
ahí|there
ahijado/a|godson, godchild
ahogar|to drown
ahogarse|to suffocate, drown
ahogo|breathlessness
ahondar|to deepen
ahora|now
ahorcar|to hang
ahorcarse|to hang oneself
ahorita|right now
ahorrar|to save, spare
ahorrarse|to spare oneself
ahorro|saving
ahumar|to smoke
ahumado/a|smoked
ahuyentar|to scare away
airado/a|angry
aire|air
aislar|to isolate
aislamiento|isolation
ajedrez|chess
ajeno/a|someone else's
ajetreado/a|busy
ají\ajíes|chili pepper
ajo|garlic
ajustar|to fit
ajustarse|to adjust
ajustable|adjustable
ajustado/a|fit
ajuste|fit
ala|wing
alabanza|praise
alabar|to praise
alacrán\cranes|scorpion
alambre|wire
alameda|tree-lined avenue, poplar grove
álamo|poplar
alardear|to boast
alargar|to extend
acá|here
abuso|abuse
acostumbrar|to accustom
alargarse|to become longer
alarido|howl
alarmar|to alarm
alarma|alarm
alarmante|alarming
alba|dawn
albahaca|basil
albañil|bricklayer, mason
albaricoque|apricot
albedrío|will
alberca|reservoir, swimming pool
albergar|to lodge
albergue|lodging
albóndiga|meatball
alborotar|to excite, stir up
alborotarse|to get excited
alborotado/a|excited
alborotador/dora|agitator, rioter
alboroto|ruckus
álbum|album
alcachofa|artichoke
alcalde/desa|mayor
alcancía|money box
alcantarilla|sewer, drain
alcanzar|to reach
alce|moose
alcoba|bedroom
alcohol|alcohol
alcohólico/a|alcoholic
alcoholismo|alcoholism
aldea|village
aldeano/a|villager
aleación\ciones|alloy
aleatorio/ria|random
aledaño/a|bordering
alegoría|allegory
alegrar|to cheer up, make happy
alegrarse|to be glad
alegre|happy, glad
alegremente|happily
alegría|joy, cheer
alejar|to move away, remove
alejarse|to move away, drift apart
alejado/a|moved away, remote
alejamiento|distance, estrangement
alemán/mana|german
alentar|to encourage
alentador/dora|encouraging
alergía|allergy
alérgico/a|allergic
alertar|to alert
alerta|alert
aleta|fin, flipper
alfabeto|alphabet
alfabético/a|alphabetical
alfabetismo|literacy
alfabetizar|to alphabetize
alfalfa|alfalfa
alfarería|pottery
alfil|bishop
alfiler|pin
alfiletero|pincushion
alfombra|small rug, carpet
alfombrilla|rug
alga|seaweed
álgebra|algebra
algo|something
algodón\dones|cotton
alguacil|bailiff, constable
alguien|somebody
alguno/a|some, any
algunos/nas|some, a few
alhaja|jewel
aliado/a|ally
alianza|alliance
aliarse|to form an alliance
alias|alias
alicates|pliers
alienar|to alienate
alienación\ciones|alienation
aliento|breath
aligerar|to lighten
alimentar|to feed, nourish
alimentarse|to feed itself
alimentación\ciones|feeding
alimenticio/cia|nutritional, nourishing
alimento|food
alinear|to align
alineación\ciones|alignment
aliño|seasoning, dressing
aliñar|to season, dress
alisar|to smooth
alistarse|to get ready, join up, enlist
alistamiento|enlistment
aliviar|to relieve, soothe
alivio|relief
allá|there
allanar|to level out, smooth
allanamiento|breaking and entering
allegado/a|close friend
allí|there
alma|soul
almacén\cenes|warehouse
almacenamiento|storage
almacenar|to store
almanaque|almanac
almeja|clam
almendra|almond
almíbar|syrup
almidón\dones|starch
almidonar|to starch
almirante|admiral
almohada|pillow
almorzar|to have lunch
almuerzo|lunch
alocado/a|crazy, wild
aloe|aloe
alojar|to lodge
alojamiento|lodging
alondra|lark
alpaca|alpaca
alpinismo|mountain climbing
alpinista|mountain climber
alpiste|birdseed
alquilar|to rent, lease
alquiler|rent, lease
alquitrán\tranes|tar
alrededor|around, about
alrededores|outskirts
alta|discharge
altanería|arrogance, haughtiness
altanero/a|arrogant, haughty
altar|altar
altavoz\voces|loudspeaker
alterar|to alter
alterarse|to get upset
alteración\ciones|alteration
alterado/a|upset
altercado|argument, altercation
alternar|to alternate
alternativa|alternative
alternativo/a|alternative
alterno/a|alternate
alteza|heighness
altiplano|high plateau
altitud|altitude
altivez\veces|arrogance, haughtiness
altivo/a|arrogant, haughty
alto/a|tall, high, stop
altoparlante|loudspeaker
altruista|altruist
altruismo|altruism
altura|height
alucinar|to hallucinate
alucinación\ciones|hallucination
alud|avalanche
aludir|to allude, refer
aludido/a|alluded, take it personally
alumbrar|to illuminate, light
alumbrado|lighting
alumbramiento|lighting, childbirth
aluminio|aluminum
alumno/a|student, pupil
alusión\siones|allusion
aluvión/viones|flood
alzar|to raise, lift
alza|rise
alzamiento|rise, uprising
amabilidad|kindness
amable|kind, nice
amaestrar|to train
amamantar|to nurse, breast feed
amanecer|to dawn, wake up
amanerado|mannered
amante|lover
amapola|poppy
amar|to love
amargar|to make bitter
amargado/a|bitter
amargo/a|bitter
amargura|bitterness
amarillo/lla|yellow
amarrar|to moor
ámbar|amber
ambición\ciones|ambition
ambicioso/a|ambitious
ambiente|atmosphere, environment
ambiental|environmental
ambiguedad|ambiguity
ambiguo/gua|ambiguous
ámbito|sphere, domain
ambos/bas|both
ambulancia|ambulance
ambulante|traveling, itinerant
amén|amen
amenazar|to threaten
amenaza|threat, menace
amenizar|to make pleasant
ameno/a|pleasant
americano/a|american
ameritar|to deserve
ametralladora|machine gun
amígdala|tonsil
amigdalitia|tonsilitis
amigo/a|friend
amigable|friendly
aminorar|to lessen, diminish
amistad|friendship
amistoso/a|friendly
amnesia|amnesia
amnistía|amnesty
amo/ama|master, mistress
amoldar|to adjust, adapt
amoldarse|to adapt to
amonestar|to admonish, warn
amonestación\ciones|warning, admonition
amoníaco|ammonia
amontonar|to accumulate, pile up
amontonarse|to crowd, pile up
amor|love
amordazar|to gag
amorío|love affair
amoroso/a|loving, sweet lovable
amortiguar|to muffle, tone down
amortiguador|shock absorber
amortizar|to pay off
amotinar|to incite to riot
amotinarse|to rebel, riot
amparar|to protect, shelter
ampararse|to take shelter from
amparo|shelter, refuge
ampliar|to extend, expand, enlarge
ampliación\ciones|extension
amplificar|to amplify
amplificador|amplifier
amplio/plia|ample
amplitud|amplitude
ampolla|blister, ampoule
amputar|to amputate
amputación\ciones|amputation
amueblar|to furnish
anaconda|anaconda
analfabeto/a|illiterate
analfabetismo|illiteracy
analgésico|analgesic
analizar|to analyze
análisis|analysis
analítico/a|analytical
analogía|analogy
análogo/a|analog
anaranjado/a|orange
anarquía|anarchy
anarquista|anarchist
anatomía|anatomy
ancestral|ancestral
ancho/cha|wide, broad
ancho|width
anchoa|anchovy
anchura|width
anciano/a|old
ancla|anchor
anclar|to anchor
andamio|scaffold
andanzas|adventures
andar|to walk
andén\denes|platform
andino/a|andean
andrajos|rags, tatters
anécdota|anecdote
anemia|anemia
anémico/a|anemic
anestesia|anesthesia
anestésico/a|anesthetic
anexar|to annex, attach
anfibio/bia|amphibian, amphibious
anfiteatro|amphitheatre
anfitrión/triona|host, hostess
ángel|angel
angelical|angelical
anglosajón/jona|anglo-Saxon
angosto/a|narrow
anguila|eel
ángulo|angle
angustiar|to distress, anguish
angustiarse|to become anguished
angustia|anguish, worry
angustioso/a|anguished
anhelar|to crave, yearn for
anhelante|yearning, longing
anhelo|yearning, longing
anidar|to nest
anillo|ring
animación\ciones|animation, liveliness
animado/a|animated, cheerful
animador/dora|host, cheerleader
animal|animal
animar|to aencourage, cheer up
animarse|to liven up
ánimo|spirit, soul, moods
animosidad|animosity
animoso/a|spirited
aniquilar|to annihilate
aniquilación\ciones|destruction, annihilation
anís|anise
aniversario|anniversary
ano|anus
anoche|last night
anochecer|to get dark
anónimo/a|anonymous
anonimato|anonymity
anorexia|anorexia
anormal|abnormal
anormalidad|abnormality
anotar|to write down, annotate
anotación\ciones|annotation
ansiar|to long for
ansiedad|anxiety
ansioso/a|anxious
antagónico/a|antagonistic
antagonismo|antagonism
antagonista|antagonist
antaño|long ago, yesteryear
antártico/a|antarctic
ante|before
anteanoche|the night before last
anteayer|the day before yesterday
antebrazo|forearm
anteceder|to precede
antecedente|antecedent, previous
antecesor/sora|predecessor, ancestor
antemano|beforehand
antena|antenna
anteojos|eyeglasses
antepasado/a|ancestor
antepenúltimo/a|third from last
anteponer|to place before
anterior|previous
anterioridad|beforehand
anteriormente|previously
ante|before, in front of
antesala|waiting room
antiaéreo/rea|antiaircraft
antibiótico|antibiotic
anticipar|to anticipate, move up
anticiparse|to get ahead
anticipación/ciones|anticipation
anticipado/a|advance
anticipo|advance payment
anticoncepción\ciones|contraception
anticonceptivo/a|contraceptive
anticongelante|antifreeze
anticuado/a|old fashioned
anticuerpo|antibody
antídoto|antidote
antiestético/a|unsightly
antifaz\faces|mask
antiguo/gua|ancient, old
antiguamente|long ago
antiguedad|antiquity
antihigiénico/a|non-hygienic, unsanitary
antiinflamatorio/ria|anti-inflammatory
antinatural|unnatural
antipatía|aversion, dislike
antipático/a|unpleasant
antirreglamentario/ria|unlawful
antirrobo|burglar alarm, antitheft
antisemitismo|anti-semitism
antiséptico/a|antiseptic
antisocial|antisocial
antítesis|antithesis
antojarse|to crave
antojadizo/a|capricious
antojo|whim, craving
antología|anthology
antorcha|torch
antro|dive, den
antropófago/a|anthropophagous, cannibal
antropología|anthropology
anual|annual
anualidad|annuity
anuario|yearbook
anular|to annul, cancel
anulación\ciones|cancellation, annulment
anunciar|to announce
anunciante|advertiser
anuncio|announcement
anzuelo|fishhook
añadir|to add
añadirura|additive
añejo/a|aged
año|year
añorar|to long for, miss
aorta|aorta
apagar|to turn off, switch off
apalear|to beat up
aparador|sideboard, shop window
aparato|machine, aparatus
aparecer|to appear
aparentar|to seem
aparición|appearance
apartar|to move away, set aside
apasionado/a|passionate, excited
apatía|apathy
apelar|to appeal
apellido|last name
apenar|sadden
apéndice|appendix
aperitivo|appetizer
apertura|opening
apestar|to stink
apetito|appetite
apilar|to pile up
apiñar|to pack
apio|celery
aplacar|to appease
aplanar|to flatten
aplastar|to crush
aplaudir|to applaud
aplazar|to postpone
aplicar|to apply
apodar|to nickname
apodo|nickname
apología|apology
apoplegía|apoplexy
aportar|to contribute
apostar|to bet
apóstol|apostle
apoyar|to support, lean
apreciar|to appreciate
apremiar|to urge
aprender|to learn
apresar|to capture
apresurar|to speed up
apretar|to press
aprisa|quickly
aprisionar|to imprision
aprobar|to approve of
aprovechar|to take advantage of
apuesta|bet
apuesto|good looking
apuñalar|to stab
apuntar|to point, aim
apunte|note
apurar|to hurry, rush
aquel|that
aquello/a|that
aquellos|those
aquí|here
aquietar|to calm
árabe|arab
arado|plow
araña|spider, chandelier
arancel|tariff
arbitrar|to arbitrate
árbol|tree
arbusto|shrub, bush
arca|ark
arcaico|archaic
archipiélago|archipelago
archivar|to file
arcilla|clay
arco|arch
arder|to burn
ardiente|burning
ardilla|squirrel
ardor|burning
arduo/dua|arduous
área|area
arena|sand
arete|earring
argolla|ring, hoop
arguir|to argue
argumentar|to argue
árido|arid, dry, arid
aristocracia|aristocracy
aritmética|arithmetic
armar|to arm, assemble
armario|closet, cabinet
armonizar|to harmonize, reconcile
arngentino/a|argentinian
aro|ring, hoop
aroma|scent, aroma
arpa|harp
arqueología|archaeology
arqueólogo/a|archaeologist
arquero/a|archer
arquitectura|architecture
arrancar|to pull out
arrastrar|to drag
arrebatar|to snatch
arrecife|reef
arreglar|to tidy up, fix
arrendar|to rent, lease
arrepentirse|to regret
arrestar|to arrest
arriba|up
arribar|to arrive
arriesgar|to risk, venture
arrodillarse|to kneel (down)
arrogancia|arrogance
arrojar|to hurl
arroyo|stream
arroz|rice
arrugar|to wrinkle
arruinar|to ruin
arrullar|to lull to sleep
arrullo|lullaby
arsénico|arsenic
arte|art
artefacto|artifact
arteria|artery
artesanía|handicrafts
ártico/a|arctic
articular|to articulate
artículo|article
artificial|artificial
artificio|skill
artillería|artillery
artista|artist
artritis|arthritis
arveja|pea
arzobispo|archbishop
asa|handle
asado|roasted
asaltar|to assault
asamblea|assembly
ascender|to rise up
asear|to clean
asegurar|to assure
asemejarse|be similar
aseo|cleanliness
asesinar|to murder, assassinate
asesorar|to advise, counsel
aseverar|to assert
asfixiar|to asphyxiate, suffocate
así|like this
asiático/a|asian
asiento|seat
asignar|to assign
asilo|asylum
asimilar|to assimilate
asistir|to attend
asma|asthma
asno|donkey
asociar|to associate
asolar|to devaste
asombrar|to amaze
asombroso/a|amazing
aspecto|aspect
áspero/a|rough, harsh
aspiradora|vacuum cleaner
aspirar|to aspire to
aspirina|aspirin
asquerosidad|filth
asta|flagpole
asterisco|asterisk
asteroide|asteroid
astigmatismo|astigmatism
astro|star, heavenly body
astrología|astrology
astronauta|astronaut
astronave|spaceship
astronomía|astronomy
astucia|astuteness, cunning
asueto|time off
asumir|to assume
asunto|matter, bussiness
asustar|to scare, frighten
atacar|to attack
atado|bundle
atadura|tie
atajar|to block
ataque|attack
atar|to tie up
atareado/a|busy
ataúd|coffin
atemorizar|to frighten
atención\ciones|attention
atender|to attend
atento/a|attentive
atenuar|to dim
ateo/a|atheistic
aterciopelado/a|velvety, downy
aterrar|to terrify
aterrizar|to land
aterrorizar|to terrify
atestiguar|to testify to
ático|penthouse, attic
atlántico|atlantic
atlas|atlas
atleta|athlete
atmósfera|atmosphere
átomo|atom
atónito/a|astonished
atontar|to stun, daze
atormentar|to torment
atornillar|to screw
atorrante|burm, loafer
atracar|to dock
atracción\ciones|attraction
atractivo/a|attractive
atraer|to attrack
atragantarse|to choke
atrancar|to block
atrapar|to trap, capture
atrás|back, behind
atravesar|cross
atrayente|attractive
atreverse|to dare
atribuir|to attribute
atributo|attribute
atrocidad|atrocity
atropellar|to run over
atroz|atrocious
atún|tuna
audible|audible
audiencia|aundience
audífono|headphone, earphones
audiovisual|audiovisual
auditorio|auditorium
auge|peak
augurar|to predict
aula|classroom
aullar|to howl
aumentar|to increase, raise
aumento|increase, rise
aun|even
aún|still
aunque|though, although
auricular|headphones
aurora|dawn
ausentarse|to leave, go away
auspicios|auspcies, sponsorship
australiano/a|australian
austriaco/a|austrian
auténtico/a|authentic
auto|car
autoayuda|self-help
autobús|bus
autocontrol|self-control
autocracia|autocracy
autóctono/a|native
autodefensa|self-defense
autodidacta|self-taught
autodisciplina|self-discipline
autografiar|to autograph
automático/a|automatic
automóvil|automobile
autonomía|autonomy
autopista|highway
autopsia|autopsy
autor/a|author
autoretrato|self-portrait
autoridad|authority
autorizar|to authorize
autoservicio|self-service
autosuficiente|self-sufficient
auxiliar|auxiliary, aid
avalancha|avalanche
avalar|to guarantee, endorse
avanzar|to advance
avaricia|greed, avarice
ave|bird
avellana|hazelnut
avena|oats
avenida|avenue
aventajar|to be ahead of
aventurar|to venture
avergonzar|to shame
averiar|to damage, break down
averiguar|to find out
avestruz\truces|ostrich
aviación|aviation
aviador/a|aviator
avión|airplane
avisar|to notify
avispa|wasp
axila|underarm
axioma|axiom
ayer|yesterday
ayudar|to help
ayuntamiento|town hall
azar|chance
azteca|aztec
azúcar|sugar
azufre|sulphur
azul|blue
babero|bib
bacalao|cod
bacteria|bacterium
bahía|bay
bailar|to dance
bajar|to bring down, lower, go down
bajo/a|low, short, faint
bala|bullet
balada|ballad
balancear|to balance
balazo|shot
balcón|balcony
balde|bucket
balear|to shoot
balística|ballistics
ballena|whale
ballesta|crossbow
balneario|spa
balón|ball
balsa|raft
bambú|bamboo
banana|banana
bañar|bathe
banca|banking
bandeja|tray
bandera|flag
banderilla|banderilla
bandido|bandit
banquete|banquet
baqueta|ramrod
bar|bar, tavern
barajar|to shuffle
barato/a|cheap
barba|beard
barbacoa|barbecue
barbero|barber
barbilla|chin
barca|boat
barítono|baritone
barman|bartender
barnizar|to varnish
barómetro|barometer
barquero|boatman
barra|bar, rod
barraca|hut
barrer|to sweep
barrera|barrier
barrido|sweep
barriga|belly
barril|barrel, keg
barrio|neighborhood
barro|mud
basquetbol|basketball
bastardo|bastard
basura|garbage
bata|bathrobe
batallar|to battle
batería|battery
batir|to beat
baúl|trunk, chest
bautismo|baptism
bazar|bazaar
bebé|baby
beber|to drink
beca|scholarship
béisbol|baseball
belleza|beauty
bendecir|to bless
beneficiar|to benefit
benigno|mild, benign
berenjena|eggplant
besar|to kiss
beso|kiss
bestia|beast
betún\tunes|shoe polish
biberón|baby's bottle
biblia|bible
bibliografía|bibliography
biblioteca|library
bicarbonato|baking soda
bicentenario|bicentennial
bíceps|biceps
bicicleta|bicycle
bien|well, good
bienaventurado|blessed
bienestar|welfare
bienvenido/a|welcome
bife|steak
bifocales|bifocals
bigamia|bigamy
bigote|mustache
bikini|bikini
billar|pool
billete|bill
bimensual|twice a month
binario/a|binary
biodegradable|biodegradable
biofísica|biophysics
biografía|biography
biología|biology
biomecánica|biomechanics
biopsia|biopsy
bioquímica|biochemitry
biotecnología|biotechology
bisabuelo/a|great-grandfather
bisagra|hinge
bisexual|bisexual
bisnieto/a|great-grandson
bistec|steak
bisturí|scalpel
bizcocho|sponge cake
blanco/a|white
blando/a|soft
blasfemar|to blaspheme
bloquear|to block
blusa|blouse
bobina|bobbin, reel
bobo|silly
boca|mouth
bochorno|embarrassment
bocina|horn
boda|wedding
bodega|wine cellar
bofetear|to slap
bohemio/a|bohemian
boina|beret
bola|ball
boleta|ticket
bolígrafo|ballpoint pen
boliviano/a|bolivian
bolsa|bag
bomba|bomb
bombear|to pump
bombilla|lightbulb
bombón|candy
bondad|goodness, kindness
bonificación\ciones|bonus
bonito/a|pretty
borde|border
borracho/a|drunk
borrar|to erase
borrego/a|lamb
bosque|forest
bosquejar|to sketch
bota|boot
botánica|botany
botar|to throw
bote|small boat
botella|bottle
botiquín\quines|first-aid kit
botón\tones|button
boutique|boutique
boxear|to box
boztezar|to yawn
bragueta|fly, pants zipper
braille|braille
brandy|brandy
brasa|ember
brasier|brassiere
brasileño/a|brazilian
bravo/a|fierce, savage
brazalete|bracelet
brazo|arm
brea|tar
breve|brief
brigada|brigade
brillar|to shine
brincar|to jump
brisa|breeze
británico/a|british
brizna|strand
brocha|paintbrush
broche|fastener
brócoli|broccoli
bromear|to joke
bronca|fight, row
bronce|bronze
bronquitis|bronchitis
brujería|witshcraft
brújula|compass
brusco/a|abrupt
brutal|brutal
budín\dines|pudding
budismo|buddhism
buenaventura|good luck
bueno/a|good, well
buey|ox
búfalo|buffalo
bufanda|scarf
búho|owl
buitre|vulture
bujía|spark plug
búlgaro/a|bulgarian
bulto|package
bumerán\ranes|boomerang
buque|ship
burbujear|to bubble
burdel|brothel
burlar|to trick
burocracia|bureaucracy
burro/a|donkey
bus|bus
buscar|to look for, to seek
busqueda|search
butaca|armchair
buzo|diver
byte|byte
cabalgar|to ride
caballería|cavaldry
caballero|gentleman
caballo|horse
cabaña|cabin, hut
cabaret\rets|nigthclub, cabaret
cabello|hair
cabeza|head
cabina|booth, cab
cable|cable
cabra|goat
cabrito|kid(goat)
cacao|cacao
cacarear|to crow
cacería|hunt
cacerola|pan
cacharro|thing
cachete|cheek
cactus|cactus
cadáver|corpse
cadena|chain
cadencia|cadence
cadera|hip
cadete|cadet
caducar|expire
caer|to fall
café|coffe
caída|fall
caiman|alligator
caja|box
calabozo|prison
calamar|squid
calamidad|calamity
calavera|skull
calcetín\tines|sock
calcio|calcium
calcomanía|decal
calcular|to calculate
calefacción|heating
calendario|calendar
calentar|to heat
calibre|caliber
calidad|quality
cálido|hot
caliente|hot
calificar|to qualify
caligrafía|panmanship
cáliz|chalice
calle|street
calma|calm, quiet
calor|heat
calumnia|slander, libel
caluroso/a|hot
calvo/a|bald
calzada|roadway
calzon\zones|panties
cama|bed
cámara|camera
camarero/a|waiter, waitress
camarón|shrimp
camarote|cabin, stateroom
cambiar|to change
camellos|camel
camilla|stretcher
caminar|to walk
camino|road
camión|truck
camisa|shirt
camote|sweet potato
campamento|camp
campana|bell
campaña|countryside
campeón/peona|champion
campesino/a|farm
campiña|countryside
campo|field
caña|cane
cana|gray hair
canadiense|canadian
canal|canal, channel
canario|canary
canasta|basket
cancelar|to cancel
cáncer|cancer
cancha|court, field
canciller|chancellor
canción/ciones|song
candado|padlock
candela|candle
candente|red-hot
candidato|candidate
canela|cinnamon
cañería|pipes
cangrejo|crab
canguro|kangaroo
caníbal|cannibal
canino/a|canine
canjear|to exchange
canoa|canoe
canonizar|to canonize
canoso/a|gray-haired
cansar|to tire
cansarse|get tired
cantar|to sing
cantera|quarry
cantidad|quantity
cantimplora|canteen, water bottle
cantina|canteen, tavern
canto|song
caos|chaos
capa|cape, cloak, coat
capacidad|capacity
capataz\taces|foreman
capaz\paces|able
capellán\llanes|chaplain
capilla|chapel
capital|capital
capitán/a|captain
capitolio|capitol
capítulo|chapter
capricho|whim
cápsula|capsule
capturar|to capture
caqui|khaki
cara|face
caracol|snail
carácter/racteres|character
característico|characteristic
caramelo|caramel
carátula|mask, face
caravana|caravan
carbohidrato|carbohydrate
carbón\bones|charcoal
carcajada|loud laugh
cárcel|jail, prison
cardenal|cardinal
cardiáco/a|cardiac
cardinal|cardinal
cardiólogo/a|cardiologist
carga|to load
cargo|charge
cariarse|decay
caribe|caribbean
caricatura|caricature
caricia|caress
caridad|charity
cariño|affection
caritativo/a|charitable
carnal|carnal
carne|meat
carnero|sheep
carnet|card
carnicería|butcher shop
carnívoro/a|carnivorous
carnoso/a|fleshy
caro/a|expensive
carpa|carp, tent
carpeta|folder
carpintería|carpentry
carpintero/a|carpenter
carrera|running
carretera|highway
carrito|troley, cart
carro|car,wagon, automobile
carroña|carrion
carroza|carriage
carta|letter
cartera|briefcase
cartero/a|mail carrier
cartílago|cartilage
casa|house
casar|to marry
cascabel|small bell
cascada|waterfall
cascanueces|nutcracker
casi|almost
casino|casino
cassette|cassette
castaña|chestnut
castaño/a|chestnut
castañuela|castanet
castellano|spanish
castidad|chastity
castigar|to punish
castillo|castle
castrar|castrate
casual|chance
cataclismo|cataclysm
catalogar|to catalog
catálogo|catalog
catarata|waterfall
catarro|cold
catástrofe|catastrophe
catecismo|catechism
cátedra|chair
catedral|cathedral
catedrático/a|professor
categoría|category
catolicismo|catholicism
católico/a|catholic
catorce|fourteen
catre|cot
cauce|riverbed
caucho|rubber
causar|to cause, provoke
cáustico/a|caustic
cautela|caution
cautivar|to capture
cavar|to dig
caverna|cavern
cavidad|cavity
cavilar|to ponder
cazar|to hunt
cd|cd, compact disc
cebada|barley
cebolla|onion
cebra|zebra
cédula|document
ceja|eyebrow
celebrar|to celebrate
celda|cell
célebre|famous
celeste|sky blue
celibato|celibacy
celo|zeal
celofán|celophane
celoso/a|jealous
célula|cell
cementerio|cementery
cemento|cement
cena|dinner
cenar|to have dinner
cenicero|ashtray
ceniza|ash
censo|census
censurar|to censor
centavo|cent
centenar|hundred
centeno|rye
centésimo/a|hundredth
centigrado|centigrade
centigramo|centigram
centímetro|centimeter
centinela|sentinel
central|central
centrar|to center
centroamericano|central american
cepillo|brush
cera|wax
cerámica|ceramics
cerca|fense, close, near
cercar|to fence
cerda|bristle
cerdo|pig
cereal|cereal
cerebro|brain
ceremonia|ceremony
cereza|cherry
cero|zero
cerrar|to close
cerro|hill
certeza|certainty
certificar|to certify
cerveza|beer
cesar|to cease
cesárea|cesarean
césped|grass
cesta|basket
chacra|farm
chal|shawl
chaleco|vest
chamarra|jacket
champaña|champagne
champiñón|mushroom
champú|shampoo
chancho|pig
chantaje|blackmail
chaqueta|jacket
charlar|chat
chauvinismo|chauvinism
chef|chef
cheque|check
chequear|to check
chícharo|pea
chicharrón\rrones|pork rind
chicle|chewing gum
chico/a|boy, girl
chile|chili pepper
chileno/a|chilean
chimenea|chimney
chimpancé|chimpanzee
chino/a|chinese
chiquillo/a|child
chisme|gossip
chiste|joke
choclo|corn
chocolate|chocolate
chofer|driver
choque|shock
chorizo|sausage, chorizo
choza|hut
chuleta|cutlet, chop
chupar|to suck
cíclico/a|cyclical
ciclismo|cycling
ciclo|cycle
ciclón\clones|cyclone
ciego/a|blind
cielo|sky, heaven
ciempiés|centipede
cien|a hundred
ciencia|science
científico/a|scientific
ciento|one hundred
cierre|closing
cierto/a|true
cifra|number, figure
cigarrillo|cigarrette
cigueña|stork
cilantro|cilantro
cilindro|cylinder
cinco|five
cincuenta|fifty
cine|cinema, movies
circo|circus
circuito|circuit
circulación|circulation
círculo|circle
circuncidar|to circumcise
circunferencia|circumference
circunstancia|circumstance
ciruela|plum
cirugía|surgery
cisne|swan
cisterna|cistern
cita|appointment, date
cítrico|citrus
ciudad|city
ciudadano/a|citizen
ciudadanía|citizenship
cívico/a|civic
civil|civil
clamar|to clamor
clan|clan
clandestino/a|clandestine
clara|egg white
claramente|clearly
claridad|clarity, clearness
clarificar|to clarify
clarividente|clairvoyant
claro/a|clearly, clear
clase|class
clásico/a|classic
clasificar|to classify
claustro|cloister
claustrofobia|claustrophobia
cláusula|clause
clausurar|close
clavado|dive
clavar|to hammer
clave|code
clavel|carnation
clavícula|collarbone
clavo|nail, clove
clemencia|clemency
clerical|clerical
cliente/a|customer, client
clima|climate
climax|climax
clip|cilp
cloaca|sewer
cloro|chlorine
clóset\sets|closet
club|club
coagular|to coagulate
coalición|coalition
coartada|alibi
cobarde|coward
cobertizo|shelter
cobertor|bedspread
cobertura|cover
cobijar|to shelter
cobra|cobra
cobrar|to charge
cobre|copper
cobro|collection
cocaína|cocaine
cocción\ciones|cooking
cocer|to cook
coche|car, automobile, coach, carriage
cochino/a|dirty
cocido/a|cooked
cociente|quotient
cocina|kitchen
coco|coconut
cocodrilo|crocodrile
coctel|cocktail
codicia|greed
código|code
codo|elbow
codorniz\nices|quail
coexistir|to coexist
cofre|coffer
coger|to take
coherencia|coherence
cohete|rocket
coincidir|to coincide
cojear|to limp
cojín\jines|cushion
cojo/a|lame, wobbly
col|cabbage
cola|tail, line, glue
colaborar|to collaborate
colapso|collapse
colcha|bedspread
colección|collection
colectividad|community
colector|sewer
colega|colleague
colegio|school
cólera|cholera
colesterol|cholesterol
colgar|to hang
colibr1|hummingbird
cólico|colic
coliflor|cauliflower
colilla|butt
colina|hill
coliseo|coliseum
colisión\siones|collision
collar|necklace
colombiano/a|colombian
colon|colon
colonia|colony
colonial|colonial
coloquial|colloquial
color|color
colosal|colossal
columna|column
columpiar|to swing
coma|coma, comma
comadre|godmother
comadreja|weasel
comadrona|midwife
comandancia|command headquarters
comarca|region
combatir|to combat, fight
combinar|to combine
combustible|fuel
comedia|comedy
comedor|dining room
comenzar|to begin, start
comer|to eat
comercio|commerce
cometa|comet
cometer|to commit
comicios|elections
cómico/a|comic
comida|food
comienzo|beginning
comillas|quotation marks
comino|cumin
comisario/ria|commissioner
comisión\siones|commission
comité|commitee
como|as, since, like
cómo|how
cómoda|chest of drawers
comodidad|comfort
cómodo/a|comfortable
comoquiera|in any way
compacto/a|compact
compadre|godfather
compañero/a|partner, companion
compañía|company
comparar|to compare
compartimiento|compartment
compartir|to share
compás|compass
compasión\siones|compassion
compatible|compatible
compatriota|compatriot
competir|to compete
compilar|to compile
complejidad|complexity
complementar|to complement
completar|to complete
complexión\xiones|constitution
complicar|to complicate
cómplice|accomplice
complot\plots|conspiracy
componer|to make up, compose
comportarse|to behave
comportamiento|behavior
composición\ciones|composition
compostura|composure
comprar|to buy, purchase
comprender|to comprehend, to understand
compresa|compress
comprensión\siones|compression
comprobar|to check
comprometer|to compromise
compuesto/a|compound
compulsivo/a|compelling
computar|to compute
computadora|computer
común\munes|common
comunicar|to communicate
comunicación\ciones|communication
comunidad|community
comunión\niones|communion
comunismo|communism
cóncavo/a|concave
concebir|to conceive
conceder|to grant
concentrar|to concentrate
concepción\ciones|conception
concepto|concept
concernir|concern
concertar|to arrange
concha|shell
conciencia|conscience
concierto|concert
concilio|council
concluir|to conclude
conclusión\siones|conclusion
concordar|to agree
concretar|to make concrete, specify
concurrir|to meet
concursar|to compete
condado|county
condenar|to condemn
condensar|to condense
condición\siones|condition
condimento|seasoning, condiment
condominio|condominium
condón|condom
conducir|to drive
conducta|behavior
conducto|duct
conductor/tora|driver
conectar|to connect
conejo/a|rabbit
conexión\xiones|connection
confeccionar|to make, prepare
confederación\ciones|confederation
conferencia|conference
confesar|to confess
confiar|to trust
confidencia|confidence
confidencial|confidential
confidencialidad|confidentiality
configuración\ciones|configuration
confirmar|to confirm
confitería|candy store
conflicto|conflict
confluencia|confluence
confortar|to comfort
confrontar|to confront
confundir|to confuse
confusión\siones|confusion
congeniar|to get along
congestión\tiones|congestion
congratular|to congratulate
congreso|congress
conjunción\ciones|conjuction
conjunto|joint, outfit, band
conmemorar|to conmemorate
conmigo|with me
conmutador|switch
cono|cone
conocer|to know, meet
conque|so
conquistar|to conquer
consagrar|to consecrate
consciencia|conscience
consecuencia|consequence
consecutivo/a|consecutive
conseguir|to obtain
consejo|advice
consentir|to allow
conserje|caretaker, janitor
conservar|to conserve
considerar|to consider
consiguiente|consequence
consistir|to consist
consolar|to console
consolarse|to console oneself
consolidar|to consolidate
consomé|consommé
consonante|consonant
consorcio|consortium
conspirar|to conspire
constancia|record, evidence
constar|to consist, be evident
constatar|to verify
constelación\ciones|constellation
consternación\ciones|consternation
constituir|to constitute
construir|to construct, build
consuelo|consolation
consultar|to consult
consumar|to complete, consummate
consumir|to consume
contabilidad|accounting
contactar|to contact
contado/a|counted, numbered
contador/dora|accountant
contagiar|to infect, transmit
contaminar|to contaminate
contar|to count
contemplar|to contemplate
contemporáneo/nea|contemporary
contender|to contend
contener|to contain
contestar|to answer, reply
contigo|with you
contiguo/gua|contiguous, adjacent
continente|continent
contingencia|contingency
continuar|to continue
contra|against
contraatacar|to counterattack
contrabandista|smuggler
contrabando|smuggling, contraband
contracción|contraction
contradecir|to contradict
contraer|to contract
contralto|contralto
contrapartida|counterpart
contrapeso|counterbalance
contrarrestar|to counteract
contraseña|password
contratar|to contract
contrato|contract
contribuir|to contribute
contrincante|opponent
contrito|contrito
controlar|to control
controversia|controversy
contundente|forceful, blunt
convalecencia|convalescence
convencer|to convince
convención\ciones|convention
convento|convent
conversar|to talk
conversión|conversion
convertir|to turn into, convert
convexo/a|convex
convicción|conviction
convidar|to invite
convincente|convincing
convivir|to coexist, live together
convocar|to convoke
conyugal|conjugal
cooperar|to cooperate
cooperación\ciones|cooperation
coordenada|coordinate
coordinar|to coordinate
copa|glass
copia|copy
coquetear|to flirt
coraje|anger, courage
coral|coral
coral|choral
corán|koran
corazón|heart
corbata|necktie, tie
corcho|cork
cordel|cord
cordero|lamb
cordial|warm
cordillera|mountain range
córdoba|cordoba (nicaraguin currency)
cordón|cord
coreografía|choreography
corneta|bugle
coro|chorus
corona|crown, wreath, garland
coronel|colonel
coronilla|crown
corporación\ciones|corporation
corporal|corporal
corporativo/a|corporative
corpulento|stout
corral|farmyard
correa|strap, belt, leash
corrección\ciones|correction
correctivo/a|corrective
correcto/a|correct
corredizo/a|sliding
corredor/dora|runner
corregir|to correct
correlación\ciones|correlation
correo|mail
correr|to run, race
corresponder|to correspond, belong
corretear|to run about, scamper
corrida|run
corriente|current
corromper|to corrupt
corrosión\siones|corrosion
corrupción\ciones|corruption
corsé|corset
cortar|to cut
cortauñas|nail clippers
corte|cut
cortejo|courtship
cortés|courteous, polite
corteza|crust, bark
cortina|curtain
corto/a|short
cosa|thing
cosechar|to harvest, reap
coser|to sew
cosmético/a|cosmetic
cósmico/a|cosmic
cosmopolita|cosmopolitan
cosmos|cosmos
cosquillas|tickle
costa|coast
costado|side
costar|to cost
costarricense|costa Rican
costilla|rib
costo|cost, price
costra|scab
costumbre|custom, habit
costura|seam, sewing
cotidiano/a|daily
cotizar|to quote
coyote|coyote
coyuntura|join, situation
cráneo|skull, cranium
crater|crater
crear|to create
creación\ciones|creation
creativo/a|creative
crecer|to grow, increase
credenciales|credentials
credibilidad|credibility
crédito|credit
credo|creed
creer|to believe
crema|cream
cremación|cremation
cremallera|zipper
cremoso/a|creamy
crepe|pancake
crepúsculo|dusk, twilight
crespo/a|curly, frizzy
cresta|crest
creyente|believer
criar|to raise, bring up
criatura|creature
crimen|crime
cripta|crypt
crisis|crisis
cristal|crystal
cristiano/a|christian
cristianismo|christianity
cristo|Christ
criterio|criterion
criticar|to criticize
cromo|chromium
crónica|chronicle
crónico/a|chronic
cronología|chronology
cronometrar|to time, clock
croqueta|croquette
cruce|cross
crucero|cruise
crucial|crucial
crucificar|to crucify
crucigrama|crossword
crudo/a|crude, raw
cruzar|to cross
cuaderno|notebook
cuadra|block
cuadrado/a|square
cuadragésimo/a|forty, fortieth
cuadrilátero|quadrilateral
cuadrilla|group
cuadro|picture, square, painting
cuadrúpedo|quadrouped
cuadruple|quadruple
cual|as, like
cuál|which, what
cualidad|quality
cualquiera|anyone
cuán|how
cuando|when
cuándo|when
cuánto|how much
cuarenta|forty
cuarentena|quarantine
cuartear|to quarter
cuarteto|quartet
cuarto/a|quarter
cuarzo|quartz
cuatro|four
cuba|cask
cubano/a|cuban
cubeta|bucket, keg
cúbico/a|cubed, cubic
cubierta|cover
cubrecama|bedspread
cubrir|to cover
cucaracha|cockroach
cuchara|spoon
cuchilla|knife, blade
cuco|cuckoo
cuello|neck
cuenta|count
cuerda|cord
cuerno|horn
cuero|leather
cuerpo|body
cuervo|crow
cuestión\tiones|matter, affair
cuidar|to take care of
culebra|snake
culo|bottom
culpa|fault
cultivar|to cultivate
culto|cultured
cumpleaños|birthday
cumplir|to accomplish, carry out
cuna|cradle
cuñado/a|brother-in-law, sister in law
cuota|fee
cupo|quota
cupón|coupon
cúpula|dome, cupola
cura|cure
curiosear|snoop
currículum|curriculum vitae
cursiva|italics
curso|course
cúspide|apex
custodia|custody
cutícula|cuticle
cutis|skin
cuyo/a|whose, of whom
dádiva|handout
daltónico/a|color-blind
dama|lady
damnificar|to damage
danés/nesa|danish
danzar|to dance
dañar|to damage
dar|to give
datar|to date
dato|data
de|of, from
debajo|underneath, under
debatir|to debate
deber|to owe
débil|weak, feeble
débito|debit
debutar|to debut
década|decade
decadencia|decadence
decaer|to decline
decano/a|dean
decencia|decency
decente|decent
decepcionar|to disappoint
decidir|to decide
decimal|decimal
décimo/a|tenth
decimocuarto/a|fourteenth
decimonoveno/a|nineteenth
decimoquinto/a|fifteenth
decimoséptimo/a|seventeenth
decimosexto/a|sixteenth
decimotercero/a|thirteenth
decir|to say, tell
decisión|decision
declarar|to declare
declinar|to decline
declive|decline
decolorar|to bleach
decoloración|decoration
decrépito/a|decrepit
decretar|to decree
dedal|thimble
dedicar|to dedicate
deducir|to deduce
defectar|to defecate
defecto|defect
defender|to defend
deferencia|deference
deficiencia|deficiency
déficit|deficit
definir|to define
deformar|to deform
defraudar|to defraud
degenerar|to degenerate
degradar|to degrade
degustar|to taste
deidad|deity
dejar|to leave
delante|ahead
delantera|front
delatar|to denounce
delegar|to delegate
deleitar|to delight
delfín|dolphin
delgado/a|thin
deliberar|to deliberate
delicia|delight
delimitar|to delimit
delicuencia|deliquency
delirante|delirious
delito|crime
delta|delta
demacrado/a|emaciated
demandar|to demand
demás|rest of the
demasiado|too much
demencia|madness
democracia|democracy
demócrata|democrat
democrático/a|democratic
demoler|to demolish
demonio|demon
demorar|to delay
demostrar|to demonstrate
denegar|to deny
denigrar|to denigrate
denominador|denominator
denotar|to denote
densidad|density
dental|dental
dentro|inside, in
denunciar|to denounce
departamento|department
depender|to depend
dependencia|dependency
deplorar|to deplore
deportar|to deport
deporte|sport
depositar|to deposit
depravado/a|depraved
deprimir|to depress
derecha|right
derecho|straight, rigth
deriva|drift
derivada|derive
derivación\ciones|derivation
derramamiento|bloodshed
derramar|to spill
derrapar|to skid
derretir|to melt
derribar|to demolish
derrochar|to waste
derrotar|to defeat
derrumbar|to collapse
desabotonar|to unbutton
desabrido/a|bland, tasteless
desacreditar|to discredit
desactivar|to deactivate
desacuerdo|disagreement
desafiar|to defy
desafío|challenge
desafortunado/a|unfortunate
desagradar|to displease
desagradecido/a|ungrateful
desahogar|to relieve
desahuciar|to evict, deprive of hope
desalentar|to discourage
desalojar|to evacuate
desamparar|abandon
desamueblado/a|unfurnished
desangrarse|to bleed, lose blood
desanimar|to discourage
desanudar|to untie
desaparecer|to disappear
desapasionado/a|dispassionate
desapercibido|unnoticed
desaprobar|to disapprove
desaprovechar|to waste
desarreglar|to mess up
desarrollar|to develop
desarrollo|development
desarticular|to break up
desaseado/a|dirty
desastre|disaster
desatar|to untie, to undo
desautorizado/a|unauthorized
desayunar|to have breakfast
desbaratar|to ruin, destoy
descafeinado/a|decaffeinated
descalificar|to disqualify
descansar|to rest
descargar|to unload
descender|to descend, go down
descifrar|to decipher, decode
descolgar|to take down
descomponer|to break down
desconectar|to disconnect
desconfiar|to distrust
descongelar|to defrost
descongestionante|descongestant
desconsiderado/a|inconsiderate
desconsolar|to distress
descontar|to discount
descontento/a|dissatisfied
descontinuar|to discontinue
descortés\teses|discourteous, rude
descremado/a|skim, nonfat
describir|to describe
descubierto/a|discovered
descubrir|to discover
descuento|discount
descuidar|to neglect
desde|from, since
desdicha|misfortune, misery
desear|to wish
desechar|to reject, trow away
desembarcar|to disembark
desempañar|to play a role
desempleo|unemployment
desencadenar|to unchain
desencajar|to dislocate
desencanto|disillusionment
desenchufar|to unplug, disconnect
desengañar|to disillusion
desenlace|ending
desenmascarar|to unmask
desenrollar|to unroll
desenterrar|to dig up, disinter
deseo|desire
desequilibrar|to unbalance
desertar|to desert
desesperar|to exasperate
desestimar|to reject
desfallecer|to weaken
desfigurar|to disfigure
desfilar|to march, parade
desgarrar|to tear, rip
desgastar|to wear away
desgracia|misfortune
deshabitado/a|uninhabited
deshacer|to undo
desheredar|to disinherit
deshidratar|to dehydrate
deshilachar|to unravel
deshonesto/a|dishonest
deshonrar|to dishonor
desierto/a|desert
designar|to designate
designio|plan
desigual|unequal
desilucionar|to disillusion, disappoint
desinfectar|to disinfect
desinflar|to deflate
desinhibido/a|uninhibited
desinteresado/a|unselfish
desleal|disloyal
desleír|to dissolve, dilute
desmantelar|to dismantle
desmejorar|to get worse
desmentir|to deny
desmontar|to dismantle, take apart
desnudar|to undress
desnutrición|malnutrition
desobedecer|to disobey
desobediencia|disobedience
desobediente|disobedient
desocupar|to vacate, empty
desodorante|deodorant
desorden|disorder
desorganizar|to disorganize
despacio|slowly
despavorido/a|terrified
despedir|to dismiss, fire
despegar|to take off, detach, unstick
despeinar|to ruffle
despejar|to clear
desperdiciar|to waste
desperfecto|flaw, defect
despertar|to wake up
despido|dismissal, layoff
despierto|awake
desplomarse|to collapse
desplumar|to pluck
despoblado/a|uninhabited
despreciar|to despise, scorn
desprender|to give off, remove
despreocupado/a|carefree
desprestigiar|to discredit
desprevenido/a|unprepared
después|afterwards, then
desquiciar|to drive crazy
destacar|to emphasize, outstanding
destapar|to open
destellar|to flash
desteñir|to fade
desterrar|to exile
destierro|exile
destinar|to assign
destituir|to dismiss
destornillar|to unscrew
destreza|skill
destrozar|to destroy
destrucción|destruction
desunir|to split, divide
desvalido/a|destitute, needy
desvanecer|to make disappear
desventaja|disadvantage
desventura|misfortune
desviación|deviation
detectar|to detect
detener|to stop
detergente|detergent
deteriorar|to damage
determinar|to determine
detestar|to detest
detonar|to detonate, explode
detrás|behind
deuda|debt
devastar|to devastate
devoción|devotion
devolución|return
devorar|to devour
devoto/a|devotee, devout
día|day
diabetes|diabetes
diablo|devil
diafragma|diaphragm
diagnosticar|to diagnose
diagonal|diagonal
diagrama|diagram
dialecto|dialect
dialogar|to have a talk
diamante|diamond
diámetro|diameter
diana|reveille
diario/ria|newspaper
diarrea|diarrhea
dibujar|to draw
diccionario|dictionary
dicha|happiness
diciembre|december
dictar|to dictate
diecinueve|nineteen
dieciocho|eighteen
dieciséis|sixteen
diecisiete|seventeen
diente|tooth
diesel|diesel
diestra|right hand
dieta|diet
diez|ten
difamar|to slander, libel
diferencia|difference
diferir|to differ
difícil|difficult
difteria|diphtheria
difundir|to spread
difunto/a|deceased
difusión\siones|diffusion
dígito|digit
dignarse|deign to
dignatario/ria|dignitary
digresión\ciones|digression
dilatar|to expand, dilate
dilema|dilemma
diligencia|diligence
diluir|to dilute
diluvio|flood
dimensión\siones|dimension
diminuto/a|tiny
dinámico/a|dynamic
dinamita|dynamite
dínamo|dynamo
dinastía|dinasty
dineral|fortune
dinero|money
dinosaurio|dinosaur
dios/diosa|god, goddes
diploma|diploma
diplomacia|diplomacy
diplomático/a|diplomat, diplomatic
diputación\ciones|delegation
dirección|address, direction
director/tora|director, manager
dirigencia|leadership
dirigente|leader, director
dirigir|to direct
discernir|to discern
disciplinar|to discipline
discípulo/a|disciple
disco|disc, disk, discus
discordante|discordant
discoteca|disco
discreción\ciones|discretion
discreto/a|discreet
discriminar|to discriminate
disculpar|to excuse
discurso|speech, discourse
discutir|to discuss
disentería|dysentery
diseñar|to design
disertación|dissertation
disfrazar|to disguise
disfrutar|to enjoy
disgustar|to upset, annoy
disidente|dissident
diskette|floppy disk, diskette
dislexia|dislexia
dislocar|to dislocate
disminuir|to reduce, decrease
disolver|to dissolve
disparar|to shoot
disparo|sho
dispensar|to dispense
dispersar|to disperse
disponer|to arrange
disposición\ciones|disposition, arrangement
dispositivo|device
dispuesto/a|prepared, ready
disputar|to dispute, argue
distanciar|to distance
distingguier|to distinguish
distorsión|distortion
distraer|to distract
distribuir|to distribute
distrito|district
disturbio|disturbance
diurno/a|day, daytime
diván|couch, divan
diversidad|diversity
diversificar|to diversify
divertir|to entertain
dividendo|dividend
dividir|to divide
divinidad|divinity
división\siones|division
divorciar|to divorce
divulgar|to divulge, reveal
doblar|to double
doce|twelve
docente|teaching
dócil|docile
doctor/tora|doctor
doctrina|doctrine
documentar|to document
dogma|dogma
dólar|dollar
doler|to hurt
domesticar|to domesticate
domicilio|home, residence
dominar|to dominate
domingo|sunday
dominio|authority
dominó|dominoes
don|gift, talent
donar|to donate
donde|where
dónde|where
dondequiera|anywhere
doquier|anywhere
dormir|to sleep
dos|two
dosis|dose
dotar|to equip, provide
dragón|dragon
drama|drama
drástico/a|drastic
drenar|to drain
droga|drug
dromedario|dromedary
dual|dual
ducha|shower
duda|doubt
duelo|duel
duende|elf
dueño/a|owner
dulce|candy, sweet
duna|dune
dúo|duo
duodécimo/a|twelfth
dúplex|duplex
duplicar|to duplicate, copy
duque|duke
durabilidad|durability
duración|duration
duradero/a|lasting, durable
durante|during
durar|to last
durazno|peach
duro|hard
ébano|ebony
ebrio/bria|drunk
ebullición|boiling
echar|to throw, cast
eclipse|eclipse
eco|echo
ecología|ecology
economía|economy
ecosistema|ecosystem
ecuación|equation
ecuador|equator
ecuatoriano/a|ecuadorian
ecuestre|ecuestrian
edad|age
edición|edition, publishing
edicto|edict
edificar|to build
editar|to publish
edredón|comforter
educar|to educate
efectivo/a|cash, effective
efervescente|effervescent
eficaz\caces|effective
eficiente|efficient
efímero/a|ephemeral
efusivo/a|effusive
agipcio/a|egyptian
ego|ego
egresar|to graduate
eje|axis
ejecutar|to execute
ejecutivo|executive
ejemplar|exemplary, issue
ejemplo|example
ejercer|to exercise, practice
ejército|army
el/a|the
él|he, him
elaborar|to elaborate
elástico/a|elastic
elección|election
electricidad|electricity
electrodo|electrode
electrodoméstico|electric appliance
electromagnético/a|electromagnetic
electrón|electron
electrónico/a|electronic
electrónica|electronics
elefante|elephant
elegir|to choose, select
elemento|element
elenco|cast
elevar|to elevate, raise
eliminar|to eliminate
elipse|ellipse
elite|elite
elixir|elixir
ella|she, her
ello|it
ellos/as|they, them
elocuente|eloquent
elocuencia|eloquence
elogiar|to praise
eludir|to elude, avoid
emancipar|to emancipate
embajada|embassy
embarazar|to embarrass, make pregnant
embarcar|to embark, board
embarque|boarding
embaucar|to trick
embellecer|to embellish
emblema|emblem
émbolo|piston
emborracharse|to get drunk
embotellar|to bottle
embriagarse|to get drunk
embrión|embryo
embrollo|tangle
embrujar|to bewitch
embrutecer|to brutalize
embudo|funnel
emergencia|emergency
emerger|to emerge
emigrar|to emigrate
eminente|eminent
emitir|to emit
emoción|emotion
emocional|emotional
empacar|to pack
empalagoso/a|cloying
empanada|pie
empapar|to soak
empapelar|to wallpaper
emparentado/a|become related
empastar|to fill with paste
empedernido|inveterate
empeñar|to pawn
empeorar|to get worse
empequeñecer|to diminish
emperador|emperor
empezar|to begin, start
empírico/a|empirical
emplear|to use, employ
empobrecer|to impoverish
empotrar|to fit, build into
emprender|to undertake
empresa|company
empujar|to push
emular|to emulate
en|in, into, inside, on
enagua|petticoat, slip
enaltecer|to praise
enamorar|to win the love of
enamorarse|to fall in love
enano/a|dwarf
encabezar|to head
encadenar|to chain
encanecer|to turn gray
encantar|to enchant
encarar|to face
encarcelar|to jail, imprisob
encarnar|to embody
encender|to light, switch on, set fire to
encerrar|to lock up
enchilada|enchilada
enchufar|to plug in, connect
encía|gum tissue
encíclica|encyclical
enciclopedia|encyclopedia
encierro|confinement
encima|on top
encinta|pregnant
encoger|to shrink
encomienda|mission, charge
encontrar|to find
encorvar|to bend, curve
encrucijada|crossroads
encuadernar|to bind
encuadrar|to fit, frame
encubrir|to conceal, cover
encuentro|encounter, meeting
encuestar|to poll
endemoniado/a|possessed, wicked
enderezar|to straighten
endeudarse|to go into debt
endiablado/a|diabolical
endulzar|to sweeten
endurecer|to harden
enema|enema
enemigo/a|enemy
energía|energy
enero|january
enésimo/a|for the umpteenth time
enfadar|to get upset, annoy, make ungry
enfatizar|to emphasize
enfermar|to become ill, make sick
enflaquecer|to lose weight
enfocar|to focus
enfrentar|to confront
enfriar|to cool
enfurecer|to infuriate
engañar|to deceive, trick, cheat on
engendrar|to beget, engender
engomar|to glue
engordar|to get fat, fatten
engrandecer|to enlarge
engrasar|to lubricate, grease
engreído/a|conceited
enhorabuena|congratulations
enigma|enigma
enjaular|to cage
enjuagar|to rinse
enlace|link
enlatar|to can
enlazar|to link
enloquecer|to drive crazy
enmarcar|to frame
enmascarar|to mask
enojar|to anger
enorgullecer|to make proud
enorme|enormous
enredadera|vine
enriquecer|to enrich
enrojecer|to blush, redden
enrolar|to enlist
enrollar|to coil, roll up
ensalada|salad
ensalzar|to praise
ensamblar|to assemble
ensangrentado/a|bloody
enseguida|immediately
enseñar|to teach
ensuciar|to soil
ensueño|dream, fantasy
entender|to understand
enterar|to find out, inform
enternecer|to touch
entero/a|whole
enterrar|to bury
entibiar|to cool
entidad|organization, entity
entierro|burial
entonar|to intone
entonces|then
entorpecer|to obstruct
entrada|entrance, entry
entrar|to enter
entre|between, among
entregar|to deliver, give
entrenar|to train
entretanto|meanwhile
entretener|to entertain
entrevistar|to interview
entristecer|to sadden
entusiasmo|enthusiasm
entusiasta|enthusiastic
enumerar|to enumerate
enunciar|to enunciate
envasar|to package
envejecer|to age
envenenar|to poison
enviar|to send
envidiar|to envy
envío|shipment, sending
envolver|to surround, wrap
enyesar|to plaster
épico/a|epic
epidemia|epidemic
epilepsia|epilepsy
epílogo|epilogue
episodio|episode
epitafio|epitaph
época|epoch, period
equilátero/a|equilateral
equilibrar|to balance
equinoccio|equinox
equipaje|luggage, baggage
equipar|to equip
equipo|equipment, team
equitación|horseback
equitativo/a|equitable
equivocar|to mistake
equivocarse|to make a mistake
era|era
erección|erection
erguir|to raise
erizo|hedgehopg
ermitaño/a|hermit
erosión|erosion
erosionar|to erode
erótico|erotic
errar|to be mistaken, miss
error|error, mistake
eructar|to burp
erudito/a|erudite
erupción\ciones|eruption
esbelto/a|slim, slender
esbozar|to outline, sketch
escabel|footstool
escalar|to climb
escalera|stairs
escalofrío|shiver, chill
escama|scale, flake
escandalizar|to scandalize
escándalo|scandal
escandinavo/a|scandinavian
escáner|to scanner
escapar|to escape, run away
escaparate|store window
escape|leak, escape
escarabajo|beetle
escarbar|to dig, poke
escarlata|scarlet
escena|scene
esceptismo|skepticism
esclarecer|to clarify
esclavo/a|slave
esclerosis|sclerosis
escoba|broom
escocer|to sting
escocés|scottish
escoger|to choose
escolar|student, pupil
escolta|escort
esconder|to hide, conceal
escopeta|shotgun
escoria|slag, dregs
escorpión\piones|scorpion
escote|neckline
escotilla|hatchway
escribir|to write
escrito/a|written
escritor/tora|writer
escritorio|desk
escritura|handwriting, deed
escrúpulo|scruple
escuadra|square, fleet
escuchar|to listen, heard
escudo|shield
escuela|school
esculpir|to sculpt
ese/a|that
esos|those
ése/a|that one
ésos|those ones
esencia|essence
esfera|sphere
esfinge|sphinx
esforzar|to strain
esfumarse|to disappear, fade away
eslavo/a|slavic
esmaltar|to enamel
esmeralda|emerald
esmoquin|tuxedo
eso|that
esófago|esophagus
espada|sword, spades
espagueti|spaghetti
espalda|back
espantar|to frighten, scare
español/ñola|spanish
esparcir|to scatter, spred
espárrago|asparagus
espasmo|spasm
espátula|spatula
especial|special
especie|species
especificar|to specify
espectáculo|show, performance, spectacle
especulación\ciones|speculation
espejo|mirror
esperar|to hope, wait
esperma|sperm
espesar|to thicken
espiar|to spy
espina|thorn
espinaca|spinach
espinilla|shin, blackhead, pimple
espinoso/a|prickly, thorny
espionaje|espionage
espíritu|spirit
espléndido/a|splendid
espolvorear|to sprinkle, dust
espontaneidad|spontaneity
espontáneo/nea|spontaneous
esporádico/a|sporadic
esposo/a|husband, wife
espumar|to foam, skim
esqueleto|skeleton
esquí|ski, skiing
esquimal|esquimo
esquina|corner
esquivar|to evade, avoid
esquizofrenia|schizophrenia
estable|stable
establecer|to establish
establecimiento|establishment
establo|stable
estaca|stake
estación\ciones|season
estadía|stay
estadio|stadium, stage
estadística|statistic
estado|state
estadounidense|american
estafar|to swindle, defraud
estallar|to explode
estampar|to print, stamp
estampida|stampede
estampilla|stamp
estancia|stay
estándar|standard
estandarte|standard
estanque|pond
estante|shelf
estar|to be, stay
estático/a|static
estatua|statue
estatura|height
estatus|status
estatuto|statute
este/a|this
estos|these
este|this
éste/a|this one
éstos|these ones
estera|mat
estéreo|stereo
estereofónico/a|stereophonic
estereotipo|stereotype
estéril|sterile
estética|aesthetic
estilo|style
estima|regard, esteem
estimular|to stimulate
estirar|to stretch
esto|this
estómago|stomach
estorbar|to obstruct
estornudar|to sneeze
estrado|platform, stage
estrafalario/ria|eccentric
estrangular|to strangle
estrategia|strategy
estratosfera|stratosphere
estrechar|to narrow
estrella|star
estrellar|to crash
estremecer|to shake, tremble
estrenar|to premiere
estreno|debut, premiere
estreñirse|to constipated
estrépito|noise
estrés|stress
estría|groove
estricto/a|strict
estropajo|scouring pad
estropear|to spoil, ruin
estructura|structure
estuche|case
estudiar|to study
estupefaciente|narcotic
estupendo/a|wonderful
etapa|stage
etcétera|et cetera
etéreo/rea|ethereal
eterno/a|eternal
ética|ethics
etimología|etymology
etíope|ethiopian
etiqueta|label
étnico/a|ethnic
eucalipto|eucalyptus
euforia|euphoria
europeo/pea|european
evacuar|to evacuate
evadir|to evade
evaluar|to evaluate
evangelio|gospel
evaporar|to evaporate
evaporación\ciones|evaporation
evasión\ciones|evasion
evento|event
eventual|possible
evidencia|evidence
evidentemente|evidently
evitar|to avoid
evolución\ciones|evolution
exacerbar|to exacerbate
exacto/a|exact
exagerar|to exaggerate
exagerado/a|exaggerated
exaltar|to exalt, arouse
examen|examination
exasperar|to exasperate
excavar|to excavate
excavación\ciones|excavation
excerder|to exceed
excedente|excessive
excelente|excellent
excelencia|excellence
excéntrico/a|eccentric
excentricidad|eccentricity
excepción\ciones|exception
excepcional|exceptional
excepto|except
exceso|excess
excitar|to excite
exclamar|to exclaim
excluir|to exclude
excomulgar|to excommunicate
excremento|excrement
exculpar|to exonerate
excursión\siones|excursion
excursionista|hiker, sightseer
excusar|to excuse
exhalar|to exhale
exhaustivo/a|exhaustive
exhausto/a|exhausted
exhortar|to exhort
exigir|to demand
exigencia|exigency
exigente|demanding
exiliar|to exile
existir|to exist
éxito|success
éxodo|exodus
exorcizar|to exorcise
exótico/a|exotic
expandir|to expand
expectativa|expectation
expedición\ciones|expedition
expediente|file, expedient
experiencia|experience
experimentar|to experiment
experimentado/a|experimented
experimental|experimental
experimento|experiment
experto/a|expert
expirar|to expire
explayar|to extend
explicar|to explain
explícito/a|explicit
explorar|to explore
exploración\ciones|exploration
explorador/dora|explorer
exploratorio/ria|exploratory
explosión\ciones|explosion
explosivo/a|explosive
explotar|to exploit
exponer|to expose
exportar|to export
exposición\ciones|exhibition, exposure
exprés|express
expresar|to express
expreso/a|express
exprimir|to squeeze
expuesto/a|exposed
expulsar|to expel, eject
exquisito/a|exquisite
éxtasis|ecstasy
extender|to extend
extensión\siones|extension
exterior|outside, exterior
exterminar|to exterminate
externo/a|external
extinguir|to extinguish
extirpar|to remove
extorsión\siones|extortion
extra|extra
extraditar|to extradite
extraer|to extract
extranjero/a|foreigner, foreign
extrañar|to miss
extrañarse|to be surprised
extraordinario/ria|extraordinary
extrasensorial|extrasensorial
extraterrestre|extraterrestrial
extravagante|extravagant
extraviar|to lose, misplace
extremar|to carry far
extremidad|extremities
extrovertido/a|extrovert
exuberante|exuberante
eyacular|to ejaculate
eyaculación|ejaculation
fabricar|to make, manufacture
fábula|fable
fabuloso/a|fabulous
facción\ciones|faction
faceta|facet
fachada|facade
facial|facial
fácil|easy
factoría|factory
factura|invoice, bill
facultad|faculty
faja|sash, girdle
falda|skirt
fallar|to fail
fallecer|to die, pass away
fallido|failed, unsuccessful
fallo|failure, error
falo|penis, phallus
falsear|to falsify
falsificación\ciones|falsification
falta|lack
fama|fame
familia|family
famosos/a|famous
fanático/a|fanatic
fanfarrón/rrona|boastful
fango|mud, mire
fantasear|to fantasize
fantasía|fantasy
fantasma|ghost
fantasmal|ghostly
fantástico/a|fantastic
farmacéutico/a|phamarcist, pharmaceutical
faro|lighthouse, headlight
fascinar|to fascinate
fascinación\ciones|fascination
fascinante|fascinating
fascismo|fascism
fase|phase
fastidiar|to annoy, bother
fatal|fatal
fatiga|fatigue
fauna|fauna
favor|favor
fax|fax
fe|faith
febrero|february
fecha|date
fecundar|to fertilize
federación|federation
felicidad|happiness
felino|feline
feliz|happy
femenino|feminine, female
fenómeno|phenomenon
feo/a|ugly
feria|fair
fermentar|to ferment
ferretería|hardware store
ferrocarril|railroad
ferry|ferry
fervor|fervor
festejar|to celebrate
festival|festival
fetiche|fetish
fétido/a|foul-smelling
feto|fetus
fiable|reliable
fianza|bail, bond
fiar|guarantee
fibra|fiber
ficción\ciones|fiction
ficha|card, token, counter
fichar|to file
ficticio/cia|fictitious
fidelidad|fidelity
fideo|noodle
fiebre|fever
fieltro|felt
fiero/a|fierce, wild
fierro|iron
fiesta|celebration, party
figura|to figure
fila|row, line
filantropía|philantropy
filete|fillet
filial|filial, branch
filigrana|watermark, filigree
filipino/a|Philippine
filmar|to film
filoso/a|sharp
filosofía|philosophy
filtrar|to filter
fin|end
final|end, final
financiar|to finance
finca|property, farm
fingir|to pretend, feign
finito/a|finite
finlandés/desa|finn
fino/a|fine
firma|company, signature
firmamento|firmament
firme|firm, resolute
fiscal|fiscal
física|physics
fisiología|physiology
fisioterapia|physiotherapy
fisioterapeuta|physical therapist
fisura|fissure
flácido/a|flabby, flacid
flaco/a|skinny, thin
flagrante|flagrant
flamante|bright
flamenco/a|flamenco
flaquear|to weaken
flash|flash
flecha|arrow
flema|phlegm
flexible|flexible
flirtear|to flirt
flojo/a|loose, slack
flojera|lethargy
flor|flower
flota|fleet
flotar|to float
fluctuar|to fluctuate
fluir|to flow
fluorescente|fluorescent
fluoruro|fluoride
fluvial|river
fobia|phobia
foco|spotlight, floodlight
fogata|bonfire
fogoso/a|ardent
folklore|folklore
folleto|pamphlet
fomentar|to promote
fondo|bottom, rear
fonético/a|phonetic
fontanería|plumbing
fontanero/a|plumber
forajido/a|bandit
forastero/a|stranger
forense|forensic
formal|formal
formalidad|formality
formar|to form
formato|format
formidable|formidable
fórmula|formula
formular|to formulate
formulario|form
forrar|to cover
fortalecer|to strengthen
fortaleza|strength, fortress
fortificar|to fortify
fortuito/a|fortuitous
fortuna|fortune
forzar|to force
fósforo|phosphorus
fósil|fossil
foto|photo
fotocopia|photocopy
fotocopiadora|photocopier
fotocopiar|to photocopy
fotogénico/a|photogenic
fotografía|photography
fotosíntesis|photosynthesis
fracasar|to fail
fracción\ciones|fraction
fractura|fracture, break
fragancia|fragrance
fragata|frigate
frágil|fragile
fragilidad|fragility
fragmento|fragment
fraile|friar
frambruesa|rasberry
francés/cesa|french
francés|french
francotirador/dora|sniper
franela|flannel
franqueza|frankness
frasco|bottle, flask
frase|phrase
fraternal|brotherly, fraternal
fraude|fraud
frazada|blanket
frecuencia|frequency
fregadero|sink
freir|to fry
frenar|to brake, restrain
freno|brake, restraint
frente|in front
fresa|strawberry
fresco/a|fresh
frialdad|coldness
fricción\ciones|friction
frigidez|frigidity
frigorifico|refrigerator
frijol|bean
frío/a|cold, cool
frito/a|fried
frívolo/a|frivolous
frontera|border, frontier
frotar|to rub
fructífero/a|fruitful
frugal|frugal
frustar|to frustate
fruta|fruit
fucsia|fuchsia
fuego|fire
fuente|source
fuera|outside, out
fuerte|hard, strong
fuerza|force, strength
fuga|flight, escape
fumar|to smoke
función|function
funcionar|to work, run, function
funda|cover
fundar|to establish, found
fundir|to melt down, smelt
fúnebre|funeral, gloomy
funeral|funeral
gabinete|cabinet
gafas|glasses
gala|gala
galante|gallant
galaxia|galaxy
galera|galley
galería|gallery
gallego/a|galician
galleta|cookie, cracker
gallina|hen
gamuza|chamois
gana|desire
ganado|cattle, sheep
ganador/dora|winner
ganancia|gain
ganar|to win
ganga|bargain
gangrena|gangrene
gángster|gangster
garaje|garage
garantizar|to guarantee
garbanzo|chickpea
garganta|throat
garrapata|tick
garza|heron
gas|gas
gaseosa|soda, soft drink
gasolina|gasoline
gastar|to spend
gástrico/a|gastric
gastronomía|gastronomy
gatas|on all four
gatear|to crawl
gatillo|trigger
gato/a|cat
gaveta|drawer
gaviota|gull, seagull
gay|gay
géiser|geyser
gelatina|gelatin
gema|gem
gemelo|twin
gemir|to moan
genealogía|genealogy
generación\ciones|generation
generador|generator
general|general
generar|to generate
género|kind, sort
generoso/a|generous
génesis|genesis
genética|genetics
genial|brilliant
genio|genius
genital|genital
genocidio|genocide
gente|people
gentil|gentile, kind
gentío|crowd, mob
genuino/a|genuine
geografía|geography
geología|geology
geometría|geometry
geranio|geranium
gerencia|management
geriatría|geriatrics
germen|germ
germinar|to germinate
gestación|gestation
gestión|management, procedure
gesto|gesture
gigante|giant
gimnasia|gymnastics
ginebra|gin
ginecología|gynecology
gira|tour
girar|to turn, twist
girasol|sunflower
giratorio/ria|revolving
giro|turn
giroscopio|gyroscope
gitano/a|gypsy
glaciar|glacier
gladiador|gladiator
glándula|gland
glasear|to glaze
gliserina|glycerin
globo|globe
glóbulo|blood cell
gloria|glory
glorieta|bower
glorificar|to glorify
glorioso/a|glorious
glosario|glossary
glucosa|glucose
gobernar|to govern
goce|enjoyment
gol|goal
golf|golf
golfo|gulf
golondrina|swallow
golosina|sweet, candy
golpe|blow
goma|rubber, glue
gordo/a|fat, plump
gorila|gorilla
gorjear|to chirp
gorra|cap
gorrear|to bum
gorrión|sparrow
gorro|cap
gota|drop, gout
gótico/a|gothic
gozar|to enjoy
gozo|joy
grabar|to record
gracia|grace
grada|step, stair
graduar|to graduate
gráfico/a|graph
gragea|pill, tablet
gramática|grammar
gramo|gram
grande|big, great
granero|barn, granary
granito|granite
granizar|to hail
granja|farm
grano|grain
grasa|grease, fat
gratificación\ciones|bonus, gratification
gratis|free
gratitud|gratitude
grato/a|pleasant
gratuito/a|free, gratuitous
gravar|to burden
gremio|guild, union
griego/a|greek
grieta|crack
grillo|cricket
gringo/a|gringo, yankee
gripe|flu
gris|gray
gritar|to shout, scream
grosería|vulgar, gross
grotesco|grotesque
grúa|crane, derrick
grueso/a|thick
gruñir|to growl, grunt
grupo|group
guacamayo|macaw
guacamole|guacamole
guagua|baby
guante|glove
guapo/a|handsome, good-looking
guarani|guarani, language of paraguay
guarda|keeper, custodian
guardabarros|mudguard, fender
guardabosque|forest ranger
guardacostas|coastguard, vessel
guardaespaldas|bodyguard
guardameta|goalkeeper
guardapolvo|cover, overalls
guardar|to keep
guardarropa|wardrobe, cloakroom
guardería|nursery
guatemalteco/a|guatemalan
guayaba|guava
gubernamental|governmental
guerra|war
guiar|to guide
guinda|morello
guiñar|to wink
guión|script
guisado|stew
guisante|pea
guisar|to cook
guitarra|guitar
gusano|worm
gustar|to taste, like
haba|broad bean
habanero/a|havanan
haber|to have, has
habichuela|bean
hábil|able, skillful, clever
habilitar|to equip, furnish
habitar|to inhabit, reside
hábito|habit
hablar|to speak, talk
hacedor/dora|maker
hacendado/a|landowner, rancher
hacer|to do, make
hacha|hatchet, ax
hacia|towards
hacienda|property, ranch
hada|fairy
halagar|to flatter
halcón|hawk, falcon
hallar|to find, discover
hamaca|hammock
hambre|hunger
hamburguesa|hamburger
haragán/gana|lazy
harina|flour
hasta|until, even
hazaña|feat
hebreo/brea|hebrew
hechizo|spell, charm
hecho/cha|fact
helar|to freeze
helicóptero|helicopter
hembra|female
hemisferio|hemisphere
hemorragia|hemorrhage
hemorroides|hemorrhoids
heno|hay
hepatitis|hepatitis
heraldo|herald
heredar|to inherit
herencia|inheritance
herir|to hurt
hermano/a|brother
hermanastro/a|stepbrother
hermético/a|hermetic
hermoso/a|beautiful
héroe|hero
herradura|horseshoe
herramienta|tool
herrero/a|blacksmith
hervir|to boil
heterogéneo/a|heterogenous
heterosexual|heterosexual
hexágono|hexagon
hexagonal|hexagonal
híbrido/a|hybrid
hidratante|moisturizing
hidráulico/a|hydraulic
hidroavión\aviones|hydroplane
hidroeléctrico/a|hydroelectric
hidrofobia|rabies
hidrógeno|hydrogen
hidroplano|hydroplane
hiel|bile
hielo|ice
hierba|grass
hierro|iron
hígado|liver
higiene|hygiene
higo|fig
hijo/a|son, daughter
hilar|to spin
hilera|file, row
hilo|thread
himno|hymn
hinchar|to swell
hindú|hindu
hiperactivo/a|hyperactive
hipersensible|hypersensible
hipertensión\siones|hypertension
hipnosis|hypnosis
hipnotismo|hypnotism
hipo|hiccup
hipocondríaco/a|hipocondriacal
hipocrecía|hypocrisy
hipodérmico/a|hypodermic
hipódromo|racetrack
hipopótamo|hippopotamus
hipoteca|mortgage
hipótesis|hypothesis
hirviente|boiling
hispano/a|hispanic
histeria|hysteria
historia|history
hockey|hockey
hoja|leaf
hola|hello
holandés/desa|dutch
holocausto|holocaust
hombre|man
hombría|manliness
hombro|shoulder
homenaje|tribute, homage
homeopatía|homeopathy
homicidio|homicide, murder
homogéneo/nea|homogenous
homólogo/a|homologous
homosexual|homosexual
homosexualidad|homosexuality
hondo/a|deep
hondureño/a|honduran
honesto/a|honest, decent
hongo|fungus, mushroom
honor|honor
hora|hour
horario|schedule, timetable
horizonte|horizon
hormiga|ant
hormiguero|anthill
hormona|hormone
horno|oven
horóscopo|horoscope
horrendo|horrendous
horripilante|horrifying
horroroso/a|horrifying
hortaliza|vegetable
horticultura|horticulture
hospedar|to lodge, put up
hospital|hospital
hostería|small hotel, inn
hostia|host
hostigar|to harass, whip
hostil|hostile
hotel|hotel
hoy|today
hoyo|hole
hueco/a|hollow
huelga|work strike
huella|footprint
huérfano/a|orphan
huerta|truck farm, orchard
hueso|bone
huésped/peda|guest
huesudo/a|bony
huevo|egg
huida|flight, escape
huir|to flee, escape
humano/a|human
humear|to smoke
humedad|humidity
humildad|humility
humo|smoke
humor|humor
hundir|to sink
hundido/a|sunk
hundimiento|sinking, collapse
húngaro/a|hungarian
huracán|hurricane
ibérico/a|iberian
iceberg|iceberg
icono|icon
ida|outward journey
idea|idea
ideal|ideal
identidad|identity
ideología|ideology
idioma|language
idiosincrasia|idiosyncrasy
idiota|idiot
ídolo|idol
idóneo/nea|suitable
iglesia|church
iglú|igloo
ignorar|to ignore
igual|equal
iguladad|equality
iguana|iguana
ilegal|illegal
ilegible|illegible
ilegítimo/a|illegitimate
ileso/a|unharmed
ilícito/a|illicit
ilimitado/a|limitless
ilógico/a|illogical
iluminar|to illuminate
ilusionar|to excite
iluso/a|gulible, naive
ilustrar|to illustrate
ilustre|it illustrates
imagen\imágenes|image
imaginar|to imagine
imán|magnet
imbécil|stupid, idiot
imitar|to imitate
impaciencia|impatience
impacto|impact
impar|odd number
imparcial|impartial
impartir|to distribute, impart
impecable|impeccable
impedir|to prevent
impenetrable|impenetrable
impenitente|unrepentant
imperativo/a|imperative
imperceptible|imperceptible
imperdonable|unforgivable
impermeable|raincoat, waterproof
impersonal|impersonal
impertinente|impertinent
implacable|implacable
implantar|to implant
implemento|implement
implicar|to imply, implicate, involve
implícito/a|implicit
implorar|to implore
imponer|to impose, command
impopular|unpopular
importación\ciones|importation
importaciones|imports
importado|imported
importador/dora|importer, importing
importancia|importance
importe|price, amount
imposible|impossible
imposibilidad|impossibility
imposición\ciones|imposition
impostor/tora|impostor
impotente|impotent
impotencia|impotence
impredecible|unpredictable
impregnar|to impregnate
imprenta|printing
imprescindible|essential
impresión\siones|impression
impresionante|impressive
impresionar|to impress
impreso/a|printed, form
imprimir|to print
improbable|improbable
improbabilidad|improbability
improductivo/a|unproductive
impropio/pia|improper
improvisar|to improvise
imprudente|imprudent
imprudencia|imprudence
impúdico/a|shameless
impuesto|tax
impugnar|to challenge
impulsar|to propel, drive
impuro/a|impure
inaccesible|inaccessible
inaceptable|unacceptable
inactivo/a|inactive
inadaptado/a|maladjusted
inadecuado/a|inadequate
inadvertido/a|inadvertent
inalámbrico/a|wireless
inanimado/a|inanimate
inaplicable|inapplicable
inapreciable|inperceptible
inaugurar|to inaugurate
inca|inca, incan
incalculable|incalculable
incandescencia|incandescence
incautar|to seize, confiscate
incentivo|incentive
incertidumbre|uncertainty
incidencia|incidence
incienso|incense
incierto/a|uncertain
incipiente|incipient
incitar|to incite, rouse
incivilizado/a|uncivilized
inclinar|to incline
incluir|to include
inclusión|inclusion
incógnito/a|incognito, unknown
incoherente|incoherent
incoloro/a|colorless
incombustible|fireproof
incomible|inedible
incomodar|inconvienence
incomparable|incomparable
incompatible|incompatible
incompetente|incompetent
imcomprendido/a|misunderstood
incomunicado/a|isolated
inconcebible|inconceivable
inconcluso/a|unfinished
incondicional|unconditional
inconfundible|unmistakable
incongruente|incongruous
inconsciente|unconscious
inconsecuente|inconsistent
inconsiderado/a|inconsiderate
inconsistente|flimsy
inconsolable|inconsolable
inconstante|inconstant
inconstitucional|unconstitutional
incontable|countless
incontestable|indisputable
incontinente|incontinent
incontinencia|incontinence
inconveniente|inconvenient
incorporar|to incorporate
incorrecto/a|incorrect
incorregible|incorrigible
increíble|incredible
incrementar|to increase
incrustar|to inlay, set
incubar|to incubate
incubadora|incubator
incuestionable|unquestionable
inculcar|to instill
inculpar|to accuse
inculto/a|uneducated
incumplimiento|breach, noncompliance
incurable|incurable
incurrir|to incur
incursión\siones|raid
indagar|to investigate
indebido/a|undue
indecente|indecent
indecible|unexpressible
indecisión|indecision
indefenso/a|defenseless, helpless
indefinido/a|indefinite
indemnizar|to compensate, indemnify
independiente|independent
independencia|independence
indescriptible|indescribable
indeseable|undesirable
indicar|to indicate
índice|index
indiferente|indifferent
indígena|native, indigenous
indigente|indigent
indigestión\tiones|indigestion
indio/dia|indian
indirecta|hint
indisciplina|indiscipline
indiscreto/a|indiscreet
indiscriminado/a|indiscriminate
indispensable|indispensable
indisponer|to upset, make ill
indistinto/a|indistinct
individual|individual
individualidad|individuality
indivisible|indivisible
indolente|indolent
indómito/a|indomitable
indonesio/sia|indonesian
inducir|to induce
indulgente|indulgent
indulgencia|indulgence
industria|industry
inédito/a|unpublished
inefable|indescribable, inexpressible
ineficaz|ineffective
ineficiente|inefficient
ineligible|ineligible
inepto|inept
inequivoco/a|unequivical
inercia|inertia
inerte|inert
inesperado/a|unexpected
inevitable|inevitable
inexistente|nonexistent
inexorable|inexorable
inexperiencia|inexperience
inexplicable|inexplicable
infalible|infallible
infancia|childhood
infarto|heart attack
infatigable|tireless
infectar|to infect
infección\ciones|infection
infeccioso/a|infectious
infeliz\lices|unhappy
inferior|inferior
infernal|infernal
infestar|to infest
infiltrar|to infiltrate
inflación|inflation
inflamar|to inflame
inflar|to inflate
inflexible|inflexible
infligir|to inflict
influencia|influence
influir|to influence
información\ciones|information
informal|unreliable, informal
informar|to inform
informe|report
infortunado/a|unfortunate
infortunio|misfortune
infracción\ciones|infraction
infraestructura|infrastructure
infrahumano/a|subhuman
infrarrojo/a|infrared
infrecuente|infrequent
infringir|to infringe
infundado/a|unfounded, baseless
infundir|to instill, infuse
ingeniar|to invent, think up
ingeniería|engineering
ingeniero/a|engineer
ingenio|ingenuity
ingenuidad|naivete, ingenuousness
ingerir|to ingest
inglés/glesa|english
ingrato|ungrateful
ingrediente|ingredient
ingresar|to enter, join
inhabitable|uninhabitable
inhalar|to inhale
inherente|inherent
inhóspito/a|inhospitable
inhumano/a|cruel, inhuman
iniciar|to initiate
inigualado/a|unequaled
ininterrumpido/a|uninterrupted
injerirse|to interfere
injuriar|to insult
injusticia|injustice
inmaculado/a|immaculate
inmaduro/a|immature
inmediato/a|immediate
inmenso/a|immense
inmigrar|to immigrate
inmobiliario/ria|real estate
inmoral|immoral
inmortal|immortal
inmóvil|immovable, motionless
inmueble|building, property
inmunizar|to immunize
innecesario/ria|unnecessary
innovar|to innovate
innumerable|innumerable
inocencia|innocence
inocent|innocent
inocuo/cua|innocuous
inodoro/a|toilet, odorless
inolvidable|unforgettable
inoperable|inoperable
inorgánico/a|inorganic
inoxidable|stainless, rustproof
inquilino/a|renter, tenant
inquirir|to inquire
insalubre|unhealthy
insatisfecho/cha|unsatisfied
inscribir|to register, enroll
insecto|insect
inseguro/a|insecure, uncertain
insensato/a|senseless
insensible|insensitive
inseparable|inseparable
insertar|to insert
insignia|standard, badge
insignificante|insignificant
insistir|to insist
insolación\ciones|insolation, sunstroke
insolencia|insolence
insoluble|insoluble
insospechado/a|unsuspected, unexpected
inspeccionar|to inspect
inspirar|to inspire
inspirador/dora|inspirational
instalar|to install
instancia|request
instantáneo/nea|instantaneous
instaurar|to establish
instinto|instinct
institución\ciones|institution
institucionalizar|to institutionalize
instruir|to instruct
instrumento|instrument
insubordinado/a|insubordinate
insuficiente|insufficient
insulina|insulin
insultar|to insult
insuperable|insurmountable
insurrección\ciones|insurrection
intacto/a|intact
intangible|intangible
integrar|to integrate
intelecto|intellect
inteligencia|intelligence
inteligente|intelligent
inteligible|intelligible
intempestivo/a|untimely
intención\ciones|intention
intensidad|intensity
intentar|to try
intercambio|exchange
intercambiar|to exchange, trade
interceder|to intercede
interés\reses|interest
interfaz|interface
interferir|to interfere
interior|interior, inner
interjección\ciones|interjection
intermediario/ria|intermediary
intermedio/dia|intermediate
intermedio|intermission
interminable|interminable
intermisión\siones|intermission
intermitente|intermittent
internacional|international
internar|to commit, confine
interponer|to interpose
interpretar|to interpret
interpretación\ciones|interpretation
interrogar|to interrogate
interrogación\ciones|interrogation
interrumpir|to interrupt
interrupción\ciones|interruption
interscción\ciones|intersection
intervenir|to take part
intestino|intestine
intimar|to become friendly
intimidar|to intimidate
íntimo/a|intimate
intolerable|intolerable
intoxicar|to intoxicate, poison
intrascendente|insignificant, unimportant
intravenoso/a|intravenous
intrépido/a|intrepid, fearless
introducción\ciones|introduction
introvertido/a|introvert, introverted
intrusión\siones|intrusion
intuir|to intuit, sense
inundar|to flood
inútil|useless
invadir|to invade
invalidez\deces|dissability, invadility
invariable|invariable
invasión\siones|invasion
invencible|invincible
inventar|to invent
inventario|inventory
invernal|winter
inversión\siones|investment
inverso/a|inverse, opposite
inversor/sora|investor
invertebrado/a|invertebrate
invertir|to invert, reverse
investidura|investiture
investigar|to investigate
investir|to invest
invicto/a|undefeated
invierno|winter
invisible|invisible
invitar|to invite
invocar|to invoke
invulnerable|invulnerable
inyectar|to inject
inyección\ciones|injection
ion|ion
ir|to go
ira|rage, anger
iraní|iranian
iraquí|iraqi
iris|iris
irlandés/desa|irish
irracional|irrational
irradiar|to radiate, irradiate
irrazonable|unreasonable
irreconocible|unrecognizable
irrecuperable|non-recoverable, irretrievable
irreemplazable|irreplaceable
irreflexivo/a|unthinking, rash
irregular|irregular
irrelevante|irrelevant
irreparable|irreparable
irresistible|irresistible
irrespetuoso/a|disrespectful
irresponsable|irresponsible
irresponsabilidad|irresponsibility
irreverente|irreverent
irrigar|to irrigate
irritar|to irritate
irrumpir|to burst into
isla|island
islámico/a|islamic
islandés/desa|icelandeic
isleño/a|islander
israelí|israeli
italiano|italian
itinerario|itinerary
izar|to hoist
izquierda|left
jabalí|wild boar
jabalina|javelin
jabón|soap
jactarse|to boast, brag
jadear|to pant
jaguar|jaguar
jalar|to pull
jalea|jelly
jamás|never
jamón|ham
japonés/nesa|Japanese
jaque|check, checkmate
jaqueca|headache, migraine
jarabe|syrup
jardín\dines|garden
jarra|pitcher, jug
jaula|cage
jauría|pack of hounds
jazmín|jasmine
jazz|jazz
jeans|jeans
jefe/a|chief, leader, boss
jengibre|ginger
jerarquía|hierarchy, rank
jerez|sherry
jeringa|syringe
jeroglífico|hieroglyphic
jersey|jersey
jesús|jesus
jinete|rider, horseman
jirafa|giraffe
joroba|hump
joven|young person
jovial|jovial, cheerful
joya|jewel
jubilación\ciones|retirement
júbilo|joy, jubilation
judaíismo|judaism
judía|bean
judicial|judicial
judío/a|jewish
judo|judo
juego|game, playing
juerga|spree, binge
jueves|Thursday
juez|judge, referee
jugar|to play, gambler
juglar|minstrel
jugo|juice
juguete|toy
juicio|judgment, sense
julio|July
jungla|jungle
junio|June
juntar|to join, unite
júpiter|jupiter
jurar|to swear
jurídico/a|legal
jurisdicción\ciones|jurisdiction
jurisprudencia|jurisprudence
justicia|justice
justificar|to justify
justo|just, fair
juvenil|youthful
juzgar|to judge
juzgado|court
karate|karate
kilo|kilo, kilogram
kilómetro|kilometer
kilometraje|distance in kilometers
kilométrico/a|kilometer
kilovatio|kilowatt
laberinto|labyrinth
labio|lip
labor|work, labor
labrar|to work, cultivate, till
laca|hair spray
lacra|scar
lacrimógeno|tear gas
lácteo/tea|dairy, milky way
lado|side
ladrar|to bark
ladrillo|brick
ladrón/drona|thief
lagarto|lizard
lago|lake
lágrima|tear
laguna|lagoon
lamentar|to be sorry, regret
lamer|to lick
lámina|sheet
lámpara|lamp
lampiño/a|beardless, hairless
lana|wool
lancha|boat, launch
langosta|lobster, locust
lanza|spear, lance
lanzar|to throw
lapicero|mechanical pencil, pen
lápida|tombstone
lápiz|pencil
lapso|lapse
largar|to release, go away
laringe|larynx
larva|larva
láser|laser
lastimar|to hurt
latente|latent
lateral|lateral, side
latido|beat, throb
látigo|whip
latín|latin
latino/a|latin-american, latin
latir|to throb, beat
latitud|latitude
latoso/a|annoying
lavar|to wash
laxante|laxative
lazo|bond, lasso, link
leal|loyal
lección|lesson
leche|milk
lechoso/a|milky
lechuga|lettuce
lector/tora|reader
leer|to read
legal|legal
legendario/ria|legendary
legible|legible
legión\giones|legion
legionario/ria|legionary
legislar|to legislate
legislación\ciones|legislation
legislador/dora|legislator
legislatura|legislature
legítimo/a|legitimate, authentic
legua|league
legumbre|vegetable
lejano/a|distant, far away
lejía|lye
lejos|far
lencería|lingerie
lengua|language, tongue
lenguaje|language
lente|lens, eye-glasses
lenteja|lentil
leña|firewood
león/ona|lion
leopardo|leopard
lepra|leprosy
lerdo/a|clumsy, slow-witted
lesbiano/a|lesbian
lesión|wound, lesion
letal|lethal
letra|letter, handwritting, lyrics
leucemia|leukemia
levadura|yeast, baking powder
levantar|to lift, raise
leve|light, slight
ley|law
libanés/nesa|lebanese
libélula|dragonfly
liberación|liberation
liberal|liberal
liberar|to liberate, free
libertad|freedom
libertinaje|licentiousness
libido|libido
libra|pound
librar|to free
libre|free
libro|book
licencia|license, permission
licor|liquor
licuadora|mixer
líder|leader
liebre|hare
lienzo|linen cloth, canvas
liga|league
lígero/a|light
ligeramente|slightly
lija|sandpaper
lila|lilac
lima|lime, nail file
limbo|limbo
limitar|to limit
limón\mones|lemon
limosna|alms
limpiar|to clean, wipe
limusina|limousine
lindo/a|pretty, lovely
línea|line
linguísta|linguist
linterna|lantern, flash-light
lírico/a|lyric, lyrical
liso/a|smooth, flat, plain
lista|list
listo/a|ready, clever, smart
lisura|smoothness
literal|literal
literatura|literature
litoral|coastal, shore, seabord
litro|liter
liturgia|liturgy
liviano/a|light
llaga|sore, wound
llama|flame, llama
llamar|to call, phone
llano|plain, flat, straightforward
llanta|rim, tire
llanto|weeping, crying
llave|key
llegar|to arrive, come
llenar|to fill
llevar|to take, carry
llorar|to cry, weep
llover|to rain
lluvia|rain
lobo/a|wolf
lóbulo|lobe
local|premises, local
loco/a|crazy, insane
locomoción\ciones|locomotion
locución\ciones|expression
locura|madness, insanity, folly, crazy act
locutor/tora|announcer
lodo|mud
logaritmo|logarithm
lógica|logic
logotipo|logo
lograr|to obtain, achieve, get
loma|hill, hillock
lomo|back
lona|canvas
lonche|lunch
longevidad|longevity
longitud|length, longitude
loro|parrot
los/las|the
losa|slab, flagstone
lotería|lottery
loza|stoneware, crockery, earthenware
lubricar|to lubricate
lucero|bright star
luchar|to fight,struggle
lucidez\deces|lucidity
luciérnaga|firefly, glowworm
lucir|to shine
lucrativo|lucrative
luego|then, later
lugar|place
lujo|luxury
lujuria|lust
luminoso/a|luminous, shining
luna|moon
lunes|monday
lupa|magnifying glass
lustrar|to shine, polish
luto|mourning
luz|light, lighting
macabro|macabre
macarrón\rrones|macaroni, macaroon
maceta|flowerpot
machete|machete
macho|male
machucar|to crush, beat
madera|wood
madre|mother
madrastra|stepmother
madrina|godmother, bridesmaid
madurar|to mature, ripen
maestría|mastery, skill
mafia|mafia
magia|magic
magnate|tycoon, magnate
magnesia|the magnesia
magnético/a|magnetic
magnifeciencia|magnificence
magnitud|magnitude
magnolia|magnolia
mago/a|magician
maicena|cornstarch
maíz|corn
majestad|Majesty
majo/a|nice, good-looking
mal|badly, poorly, incorrectly
malabarismo|juggling
malaria|malaria
malasio/sia|malaysian
malaventura|misfortune
malayo/a|malayan
malcriado/a|spoiled
maldad|evil
maldecir|to curse, damn
maleante|crook
malentendido|misunderstanding
maleta|suitcase
maleza|weeds, underbrush
malgastar|to squander, waste
malhechor/chora|criminal
malhumorado/a|bad-tempered
malicia|malice
maligno/a|malignant
malla|mesh
malo/a|bad
malograr|to waste, fail
maloliente|smelly
malta|malt
maltratar|to mistreat
malvado/a|evil, wicked
mama|teat, breast
mamá|mother, mom
mamar|to suck
mambo|mambo
mamografía|mamogram
manada|herd
manchar|to stain
mandar|to command
mandarina|mandarin orange
mandíbula|jaw
mandil|apron
mandolina|mandolin
mandón/dona|bossy
manejar|to handle
manera|way, manner
manga|sleeve
mango|handle
manguera|hose
maní|peanut
manía|odd habit
maniático/a|fussy, fanatic
manicomio|insane asylum
manicura|manicure
manifestar|to declare
maniobra|maneuver
manipular|to manipulate
maniquí\quíes|dummy
manjar|delicacy
mano|hand
mansión\siones|mansion
manso/a|gentle
manta|blanket
manteca|butter
mantel|tablecloth
mantener|to maintain
mantequilla|butter
manto|mantle
manual|manual
manufactura|manufacture
manuscrito|manuscript
manutención\ciones|maintenance
manzana|apple
mañana|tomorrow
mapa|map
mapache|raccoon
maqueta|scale model
máquina|machine
mar|sea
maratón\tones|marathon
maravilla|wonder
marca|it marks
marcapasos|pacemaker
marcar|to mark
marchar|to march
marcial|martial
marco|frame
marea|tide, make dizzy
maremoto|tidal wave
mareo|nausea
marfil|ivory
margarina|margarine
margarita|daisy
margen|margin
mariachi|mariachi band
marihuana|marijuana
marimba|marimba
marina|navy, coast
marinero/a|sailor
marioneta|puppet
mariposa|butterfly
mariquita|ladybug
marisco|seafood
marítimo/a|marine
mármol|marble
marquesina|marquee
marrano/a|pig
marrón\rrones|brown
marroquí|Moroccan
marsupial|marsupial
marte|Mars
martes|Tuesday
martillo|hammer
mártir|martyr
marxismo|marxism
marzo|March
mas|but (más is more)
más|more, most
masacre|massacre
masaje|massage
mascar|to chew
máscara|mask
mascota|mascot
masculino/a|masculine
masilla|putty
masivo/a|massive
masoquismo|machoism
masticar|to chew
mástil|mast
masturbarse|masturbate
matamoscas|flyswatter
matar|to kill
matemáticas|mathematics
materia|matter
maternal|maternal
matinal|matinal
matiné|matinee
matrícula|register
matrimonial|married
matrimonio|marriage
matutino/a|morning
maullar|to meow
maxilar|jaw
máxima|maxim
máximo|maximum
maya|Mayan
mayo|May
mayonesa|mayonnaise
mayor|greater
mayoría|majority
mayorista|wholesaler
mayúscula|capital letter
mazmorra|dungeon
mecánica|mechanics
mecanismo|mechanism
mecanografiar|to type
mecedora|rocking chair
mecer|to rock
mecha|wick
medalla|medal
mediación\ciones|mediation
mediado/a|half-full
mediador/dora|mediator
mediano/a|medium
medianoche|midnight
mediante|by means of
medicación\ciones|medication
medición\ciones|measurement
médico/a|doctor
medida|measurement
medieval|medieval
medio/dia|means
mediocre|mediocre
mediodía|noon
medioevo|middle ages
medir|to measure
meditar|to meditate
mediterráneo/nea|mediterranean
medusa|jellyfish
megabyte|megabyte
megáfono|megaphone
mejilla|cheek
mejor|better
mejorar|to improve
melancolía|melancholy
melaza|molasses
melena|long hair
mellizo/a|twin
melocotón\tones|peach
melodía|melody
melodrama|melodrama
melón\lones|melon
membrana|membrane
membrillo|quince
memorable|memorable
memoria|memory
mencionar|to mention
mendigar|to beg
menopausia|menopause
menor|minor
menos|less
mensaje|message
menso\sa|stupid
menstruar|to menstruate
menstruación|menstruation
mensual|monthly
mensurable|mensurable
menta|mint
mental|mental
mentar|to mention
mente|mind
mentir|to lie
mentol|menhol
menú|menu
meñique|pinkie
mercado|market
mercancía|merchandise
mercenario/ria|mercenary
mercurio|mercury
merecer|to deserve
merengue|merengue dance
mérito|merit
mes|month
mesa|table
mesías|messiah
mesura|moderation
meta|it puts
metabolismo|metabolism
metafísica|metaphysics
metáfora|metaphor
metal|metal
metamorfosis|metamorphosis
meteoro|meteor
meter|to put, insert
meticuloso/a|meticulous
método|method
métrico/a|metric
metro|meter
mexicano/a|Mexican
mezcla|mixture
mezquita|mosque
mezquite|mesquite
mi\mis|my, not me
mí|me, not my
microbio|microbe
microbiología|microbiology
microbús\buses|minibus
micrófono|microphone
microondas|microwaves
microorganismo|microorganism
microscopio|microscope
miedo|fear
mientras|while
miércoles|Wednesday
migración\ciones|migration
migraña|migraine
migrar|to migrate
mil|thousand
milagro|miracle
milenio|millenium
milésimo/a|thousandth
miligramo|milligram
mililitro|milliliter
milímetro|millimeter
militante|militant
militar|military man
millar|thousand
mimar|to mimar, pamper
mímica|mimic
mimo|pampering
mina|mine
mineral|mineral
minería|mining
miniatura|miniature
minifalda|miniskirt
minimizar|to diminish
mínimo/a|minimum
minino/a|pussycat
ministerio|ministry
ministro/tra|minister
minoría|minority
minorista|retailer
minoritario/ria|minority
minúsculo/a|minuscule
minuto|minute
mío/a|mine
miope|myopic, nearsighted
mirar|to watch
misa|mass
miscelánea|miscellany
miserable|miserable
misericordia|mercy
mísero/a|miserable
misil|missile
misión\siones|mission
misionero/a|missionary
mismo|same
misterio|mystery
mistica|misticism
mitad|half
mito|myth
mixto/a|compound, mixed
mobiliario|furniture
mocasín\sines|moccasin
mochila|knapsack, backpack
moco|snot, mucus
moda|fashion
modelar|to model
módem|modem
moderar|to moderate
moderno/a|modern
modesto/a|modest
modificar|to modify
modismo|idiom
modista|dressmaker
modo|way, manner, mode
modular|to modulate
módulo|module
moho|mould, rust
moíses\seses|cradle, bassinet
mojar|to wet
molar|to molar
moldear|to mold
molécula|molecule
moler|to grind
molestar|to bother
molido/a|ground
molino|mill
molusco|mollusk
momento|moment
momentáneamente|momentarily
momentáneo/nea|momentary
momia|mummy
monarca|monarch
monasterio|monastery
mondadientes|toothpick
mondongo|innards, guts
moneda|currency, coinage, coin
monetario/ria|monetary
monitor|monitor
monja|nun
mono/a|monkey
monogamia|monogamy
monografía|monograph
monograma|monogram
monólogo|monologue
monopatín\tines|scooter
monopolio|monopoly
monosílabo|monosyllable
monoteísmo|monotheism
monotonía|monotony
monóxido|carbon monoxide
monstruo|monster
montaña|montain
montar|to mount, ride
monte|mountain, hill
montículo|knoll
montón|pile, heap
montura|mount
monumento|monument
moño|hair bun
mora|mulberry, blackberry
morada|residence
moral|moral
morar|to dwell, reside
morder|to bite
mordisquear|to nibble
moreno/a|dark skin
moretón\tones|bruise
morfina|morphine
morir|to die
morse|morse code
mortal|mortal
mortífero/a|deadly
mortificar|to mortify
mosaico|mosaic
mosca|fly
mosquito|mosquito
mostaza|mustard
mostrador|counter
mostrar|to show
mota|speck
motel|motel
motín|riot, revolt
motivo|reason
moto|motorcycle
motor|motor
mover|to move, stir
móvil|mobile
movimiento|movement, motion
mozo/a|young man, waiter
muchacho/cha|boy
muchedumbre|crowd, mass
mucho|much
mucosidad|mucus
mudo|mute
mueble|furniture
mueca|face, grimace
muela|tooth
muelle|wharf
muerte|death
muestra|sample
mugre|dirt, grime
mujer/jeres|woman, women
mulato/a|mulatto
muleta|crutch, prop
multa|fine, penalty
multicolor|multicolor
multicultural|multicultural
multimedia|multimedia
multinacional|multinational
multiplicar|to multiply
multitud|multitude
mundo|world
municiones|ammunition
municipal|policeman, municipal
muñeca|wrist, doll
mural|mural, wall
murciélago|bat
murmullo|murmur
murmurar|to murmur
muro|wall
musaraña|shrew
músculo|muscle
museo|museum
musgo|moss
música|music
muslo|thigh
musulmán/mana|muslim
mutar|to mutate
mutuo/tua|mutual, reciprocal
muy|very, highly
nabo|turnip
nácar|mother of pearl
nacer|to be born
nación\ciones|nation
nada|nothing
nadar|to swim
nadie|nobody, no-one
naipe|playing card
nalgas|buttocks, rumps
nana|granny,lullaby
naranja|orange
narciso|narcissus, daffodil
narcótico/a|narcotic
nariz\rices|nose
narrar|to narrate, tell
nasal|nasal
nata|cream, skim
natación\ciones|swimming
natal|native, birth, natal
natillas|custard
natividad|nativity, birth
nativo/a|native
natural|natural
naturaleza|nature
naturalidad|naturalness
naufragar|to be shipwrecked
náusea|nausea
náutico/a|navigation, nautical
navaja|knife
naval|naval
nave|ship
navegar|to sail
navegable|navigable
navegación\ciones|navigation
navidad|Christmas
nazi|Nazi
neblina|fog, mist
nebuloso/a|cloudy, nebulous
necedad|nonsense, silliness
necesario/ria|necessary
necesariamente|necessarily
necesidad|necessity,need
necio/cia|fool, silly, stupid
necrología|necrology
néctar|nectar
negar|to deny
negligente|negligent
negociar|to negotiate
negro/gra|black
nene/a|baby
nepotismo|nepotism
neptuno|Neptune
nervio|nerve
neumático|pneumatic, tire
neumonía|pneumonia
neurología|neurology
neurosis|neurosis
neutral|neutral
neutrón|neutron
nevar|to snow
nevera|refrigerator
ni|nor, neither
nicaraguense|nicaraguan
nicho|niche
nicotina|nicotine
nido|nest
niebla|fog
nieto/a|grandson, granddaughter
nieve|snow
nigeriano/a|Nigerian
ninfa|nymph
ninguno/a|no, none, nobody, no one
niño/a|boy, girl
nipón/pona|Japanese
níquel|nickel
nítido/a|clear, bright
nitrato|nitrate
nitrógeno|nitrogen
nivel|level
no|no
noble|nobleman, noble
noche|night
nocturno/a|nocturnal
nombrar|to name
nomo|nomo
nonagésimo/a|nineteenth
noreste|the northeast
norma|norm
noroeste|the northwest
norte|north
norteamericano/a|North American
norteño/a|northern
noruego/a|Norwegian
nosotros/tras|we
nostalgia|nostalgia
nota|note
notario/ria|notary
noticia|the news
notificar|to notify
notorio|well-known, notorious
novato/a|novice
novecientos/tas|nine hundred
novedad|newness, novelty
novela|novel
novelista|novelist
noveno/a|ninth
noventa|ninety
noviazgo|engagement
novicio/cia|novice, beginner, apprentice
noviembre|November
novio/via|boyfriend, girlfriend, fiance, fiancee
nube|cloud
nuca|nape of the neck
núcleo|nucleus
nudillo|knuckle
nudismo|nudism
nudo|knot, node
nuera|daughter-in-law
nuestro/tra|ours
nuevamente|again
nueve|nine
nuevo/a|new
nuez|nut
nulo/a|null
numerar|to number
numeración\ciones|numeration
numérico/a|numerical
nunca|never
nupcial|nuptial
nutria|otter
nutrir|to nourish
o|or
oasis|oasis
obedecer|to obey
obediencia|obedience
obediente|obedient
obeso/a|obese
obesidad|obesity
obispo|bishop
objetar|to object
objeto|object
oblicuo/cua|oblique
obligar|to force, oblige
obra|work
obsequiar|to flatter, present
obsequio|present, gift
observar|to observe
observación\ciones|observation
observador/dora|observer
obsesionar|to obsess
obstaculizar|to prevent
obstante|however, nevertheless
obstreticia|obstetrics
obstetra|obstetrician
obstruir|to obstruct
obstrucción\ciones|obstruction
obtener|to obtain, get
obtuso/a|obtuse
obviar|to avoid, obviate
obvio/via|obvious
obviamente|obviously
ocasión\siones|occasion
ocaso|decline
occidente|the West
océano|ocean
ochenta|eighty
ocho|eight
ocio|leisure, idleness
octágono|octagon
octava|eighth
octeto|byte
octogésimo|eightieth
octubre|october
ocultar|to hide
ocupar|to occupy
ocupación\ciones|occupation
ocupado/a|occupied, busy
ocurrir|to happen
odiar|to hate
odontología|dentist, odonology
odontólogo/a|dentistry
oeste|the west
ofender|to offend
oferta|supply, offer
oficial|official
oficina|office
oficio|office
ofrecer|to offer
ofrenda|offering
oftalmología|ophtalmology
oftalmólogo/a|ophtalmologist
oír|to hear
ojal|eyelet
ojo|eye
ola|wave
olé|bravo
oleada|big wave
oler|to smell
olfatear|to sniff, smell
olimpiada|olympiad
oliva|olive
olor|scent, smell, odor
olvidar|to forget
ombligo|navel
omelette|omelette
omitir|to omit
omisión\siones|omission
ómnibus|omnibus
omnipotente|omnipotente
omóplato|shoulder blade
once|eleven
onceavo|eleventh
onda|wave
onza|ounce
opaco/a|opaque
ópalo|opal
opción\ciones|option
ópera|opera
operar|to operate
opinar|to think
oriental|eastern
orientar|to orient
oriente|orient
orificio|orifice
origen/rígenes|origin
original|original
originalidad|originality
orilla|edge, border
orinar|to urinate
oriundo/a|native
ornamental|ornamental
ornitología|ornithology
oro|gold
orquesta|orchestra
orquídea|orchid
ortiga|nettle
ortodoxia|orthodoxy
ortografía|spelling
ortopedia|orthopedics
ortopédico/a|orthopedic
oruga|caterpillar
orzuelo|sty
oscuro/a|dark, obscure
óseo/sea|bony, osseous
oso/a|bear
osteoporosis|osteoporosis
ostra|oyster
otoño|autumn, fall
otorgar|to grant, award
otro/tra|another, other
óvalo|oval
ovario|ovary
oveja|sheep
ovni|ufo
ovular|to ovulate
ovulación\ciones|ovulation
oxidar|to oxidize, rust
oxígeno|oxygen
oyente|listener
ozono|ozone
pabellón|pavilion, block
pabilo|wick
paciencia|patience
pacificar|to pacify
pacto|pact, agreement
padecer|to suffer
padre|father
paella|paella
paga|wages, pay
pagano/a|pagan
pagar|to pay
página|page
pago|payment
país|country, nation
paja|straw
pájaro|bird
pajita|drinking straw
pala|shovel, spade
palabra|word
palacio|palace
paladar|taste, palate
palanca|handle, lever, crowbar
palco|theater box
palestino/a|palestinian
pálido/a|pale
palillo|small stick, toothpick
paliza|beating
palmera|palm tree
palo|stick
paloma|dove, pigeon
palpar|to feel, touch
palpitar|to beat, palpitate
palta|avocado
paludismo|malaria
pampa|pampa
pan|bread
panadería|bakery
panal|honeycomb
panameño/a|panamanian
pancito|bread roll
páncreas|pancreas
pandilla|gang
panecillo|bread roll
panel|panel, plywood
panfleto|pamphlet, lampoon
pánico|panic
panorama|panorama
panqueque|pancake
pantalla|screen
pantalón\lones|pants, trousers
pantano|marsh, swamp
pantera|panther
pantimedias|panty hose
pantomima|pantomime
pantorrilla|calf of leg
pantufla|slipper
panza|belly, paunch
pañal|diaper
paño|cloth
pañuelo|handkerchief
papa|potato, pope
papagayo|parrot
papaya|papaya
papel|paper
paquete|package
paquistaní|pakastini
par|pair, couple
para|for, towars, stop
parábola|parable
parabrisas|windshield
parachoques|bumper
parada|stop, parade
paradoja|paradox
parafrasear|to paraphrase
paraguas|umbrella
paraguayo/a|paraguayan
paraíso|paradise
paralelo/a|parallel
parálisis|paralysis
parámetro|parameter
paranoia|paranoia
parar|to stop, stand
pararrayos|lightning rods
parásito/a|parasitic, parasite
parcial|partial
parecer|to seem
pared|wall
parentela|relatives
paréntesis|parenthesis
pariente|relative
parir|give birth, have a baby
parking|parking
parlotear|to chatter
parodia|parody
párpado|eyelid
parque|park
parqué|parquet
parquear|to park
parquímetro|parking meter
párrafo|paragraph
parrilla|grill
párroco|priest, parish
parte|part
partero/a|midwife
partición\ciones|division, sharing
participar|to participate
partícula|particle
particular|particular, private
partir|to start off, depart, slipt, divide
partitura|score
parto|childbirth
pasada|happened, pass
pasaje|passage
pasamanos|handrails
pasaporte|passport
pasar|to happen, pass
pasarela|footbridge
pasatiempo|pastime, hobby
pascua|passover, easter
pase|pass
pasear|to take a walk, go for a ride
pasillo|corridor, passage
pasión\siones|passion
pasivo/a|liabilities, passive
pasmar|to astonish
paso|step
pasta|paste, pasta
pastel|pie, cake
pasteurizar|to pasteurize
pastilla|tablet, pill
pata|leg
patata|potato
patear|to kick
patentar|to patent
paternal|paternal
patético/a|pathetic
patillas|sideburns
patinar|to slide
patinador/dora|skater
patinaje|skating
patio|patio
pato/a|duck
patología|pathology
patria|mother country
patriarca|patriarch
patrimonio|patrimony
patriota|patriotic
patriotismo|patriotism
patrocinador/dora|sponser
patrón/trona|pattern
patrulla|patrol
pausa|it slows down
pavimento|pavement
pavo/a|turkey
pavor|terro
payaso/a|clown
paz|peace
peaje|toll
peatón\tones|pedestrian
peca|freckle
pecado|sin
pecador/dora|sinner
pecaminoso/a|sinful
pecar|to sin
pecera|fishbowl
pecho|chest
pecoso/a|freckled
pectoral|pectoral
peculiar|peculiar
peculiaridad|peculiarity
pedagogía|education
pedal|pedal
pedante|pedantic
pedazo|piece, bit
pedestal|pedestal
pediatra|pediatrician
pedigrí|pedigri
pedir|to request, ask for
pegar|to glue, stick
peinar|to comb
pelado/a|bare
pelar|to peel
peldaño|step
pelear|to fight
pelícano|pelican
película|film, movie
peligro|danger
pelirrojo/a|red-haired
pellejo|skin, hide
pellizcar|to tweak, pinch
pelo|hair
pelota|ball
peluca|wig
peluche|plush
peludo/a|hairy
peluquería|hairdressing salon
pelusa|fuzz
pelvis|pelvis
pena|pain, penalty
penal|penitentiary, prison
penalty|penalty
penar|to suffer, punish
péndulo|pendulum
pene|penis
penetrar|to penetrate
penicilina|penicillin
península|peninsula
penitencia|penance, penitence
penoso/a|painful, distressing
pensar|to think
pentágono|pentagon
pentagrama|music symbol, staff
penúltimo/a|next to last, penultimate
peña|rock
peón|laborer, peon
peor|worse
pepino|cucumber
pequeño/a|small
pera|pear
percepción\ciones|perception
percibir|to perceive
percusión\siones|percussion
perdiz\dices|partridge
perdón|pardon, forgiveness
perdonar|to pardon, forgive
perecer|to perish
peregrinaje|pilgrimage
peregrino/a|migratory
perejil|parsley
pereza|laziness
perfección\ciones|perfection
perfil|profile
perforar|to perforate
perfume|perfume
pergamino|parchment
pericia|skill
periódico/a|newspaper
período|period
periquito|periquito
periscopio|periscope
perla|pearl
permanecer|to remain
permeable|permeable
permitir|to allow
pernicioso/a|pernicious
pero|but
perpendicular|perpendicular
perpetrar|to perpetrate
perpetuar|to perpetuate
perplejo/a|perplexed
perro/rra|dog, bitch
perseguir|to persecute, pursue
perseverar|to persevere
persiana|blind
persistir|to persist
persona|person
perspectiva|perspective
persuadir|to persuade
pertenecer|to belong to
pertinente|pertinent
perturbar|to disturb
peruano/a|peruvian
pervertir|to pervert
perverso/a|perverse
pervertido/a|perverted
pesa|weight
pesadilla|nightmare
pesado/a|heavy
pésame|condolence
pesar|to weigh
pescado|fish
pescador/dora|fisherman
pescuezo|neck
pesebre|manger
pesimismo|pesimism
pésimo/a|terrible, awful
peso|weight
pesquero/a|fishing boat
pestaña|eyelash
peste|plague
pestilencia|pestilence
petaca|case
pétalo|petal
petardo|firecracker
petición\ciones|request
petirrojo|robin
petrificar|to petrify
petróleo|petroleum, oil
petulante|arrogant
pez|fish
pezón|nipple
pezuña|hoof
piano|piano
picante|hot
picaporte|latch, door handle
picar|to bite
picazón\zones|itch
pichón/chona|pigeon
picnic|picnic
pico|tip, beak
pie|foot
piedad|mercy, pity
piedra|stone
piel|skin
pienso|feed, fodder
peirna|leg
pieza|piece
pigmento|pigment
pigmeo/mea|pygmy
pijama|pajamas
pila|battery
píldora|pill
pillar|to catch
pillaje|looting, pillage
piloto|pilot
pimienta|pepper flakes
pimiento|pepper fruit
pimentero|pepper shaker
pimentón|paprika
pincel|brush
pinchar|to puncture
pintar|to paint
pintor/tora|painter
pintura|painting
pinza|clamp
piña|pineapple
piñata|piñata
piojo|louse
pionero/a|pioneer
pipa|pipe
pirámide|pyramid
piraña|piranha
pirata|pirate
piropo|compliment
pirueta|pirouette
pisada|footstep
pisapapeles|paperweight
pisar|to step on
piscina|swimming pool
piso|floor
pista|track, trail
pistola|pistol, gun
piyama|pajamas
pizarra|board
pizca|pinch
pizza|pizza
placa|plate, sheet, badge
placer|to please
plácido/a|placid
plaga|plague
plagiar|to plagiarize
plan|plan
plana|page
plancha|grill, iron
planchar|to iron
planear|to glide, plan
planeador|glider
planeta|planet
planificar|to plan
planilla|list, roster
plano/a|plane, flat, plan
planta|plant, floor
plantear|to expound, raise
plantel|staff, team
plantilla|insole, shoe insert
plástico/a|plastic
plata|silver, money
plataforma|platform
plátano|banana, plantain
platea|orchestra, pit
plateado/a|silverplated
platicar|to talk, chat
platino|platinum
plato|plate, dish
platónico/a|platonic
playa|beach
plaza|seat, square
plazo|term, period
plegaria|prayer
pleito|lawsuit, figth
pliego|sheet
plomería|plumbing
plomo|lead
pluma|pen, feather
plural|plural
plus|extra, bonus
plutocracia|plutocracy
plutón|Pluto
poblar|to populate, colonize
población\ciones|population
pobre|poor
poción\ciones|potion
poco/a|little, few
podar|to prune
poder|to be able to, can, might, may
podrido|rotted
poema|poem
polaco/a|Polish
polar|polar
polea|pulley
polémica|controversy
polen|pollen
policía|police
poliéster|polyester
poligamia|polygamy
polígono|polygon
polilla|moth
polio|polio, poliomyelitis
politécnico/a|polytechnic
política|politics
póliza|policy
pollo|chicken
polución\ciones|pollution
polvo|dust, powder
pomelo|grapefruit
pomo|knob
pómulo|cheekbone
ponche|punch drink
poncho|poncho
poner|to put
popa|stern
popular|popular
póquer|poker
por|by, for, per
porcelana|porcelain
porcentaje|percentage
porción\ciones|portion
porfiar|to insist
pornografía|pornography
poroto|bean
porque|because, why
porquería|nastiness, junk
portaaviones|aircraft carrier
portaequipajes|luggage rack
portar|to carry
portátil|portable
pórtico|porch, portico
portugués/guesa|Portuguese
porvenir|future
posar|to place, pose
posavasos|coaster
posdata|postscript
poseer|to posses, own
posibilidad|possibility
posición\ciones|position
positivo/a|positive
posponer|to postpone
postal|postcard
postergar|to delay, postpone
posteridad|posterity
postre|dessert
postura|position
potable|potable, drinkable
potasio|potassium
pote|jar
potencia|power
pozo|well
práctica|practice
practicar|to practice
pradera|prairie, grassland
pragmático/a|pragmatic
preámbulo|introduction, preamble
precario/ria|precarious
precaución\ciones|precaution
preciado/a|prized
precio|price, cost
precipicio|precipice
precipitar|to hasten, speed up
preciso/a|precise
preconcebido|preconceived
predecesor/sora|predecessor
predecir|to predict
predestinado/a|predestined
predeterminar|to predetermine
prédica|sermon
predicado|predicate
predicar|to preach
predicador/dora|preacher
predicción\ciones|prediction
predilección\ciones|predilection
predisponer|ready
predisposición\ciones|predisposition
predominante|predominant
prefabricado/a|prefabricated
prefacio|preface
preferir|to prefer
preferencia|preference
preferente|preferred
preferido/a|preferred
prefijo|area code
pregonar|to announce
pregunta|a question
preguntar|to ask
preguntarse|to question itself
prehistórico/a|prehistoric
prejuicio|prejudice
preliminar|preliminary
prematrimonial|premarital
prematuro/a|premature
premeditar|to premeditate
premenstrual|premenstrual
premio|prize
premiado/a|awarded, prizewinning
premiar|to award, reward
premisa|premise
premonicón\ciones|premonition
premura|haste, urgency
prenatal|prenatal
prenda|piece of clothing, pledge
prendar|to captivate
prendarse|to fall in love with
prender|to pin, capture
prenderse|to catch fire
prendedor|pin, brooch
prensa|press
preñado/a|pregnant
preocupar|to worry
preocupación\ciones|worry
preparar|to prepare
preparación\ciones|preparation
preparado/a|prepared
preparativo|preparatory
preparatoria|preparatory
preposición\ciones|preposition
prepotente|arrogant
prerrogativa|prerogative
presa|prey
presagiar|to foretell
presencia|presence
presenciar|to be present at, witness
presentar|to present
presentación\ciones|presentation
presentador/dora|presenter
presente|present
presentir|to have a presentiment of
presentimiento|premonition
preservar|to preserve
preservación\ciones|preservation
preservativo|preservative, condom
presidente|president
presidencia|presidency
presidencial|presidential
presidio|military prison
presidiario/ria|convict
presidir|to preside over
presión\siones|pressure
presionar|to press
preso/a|prisoner
prestar|to lend, loan, give
prestigio|prestige
presto/a|ready, prompt
presumir|presume
presumido/a|conceited, vain
presunción\ciones|presumption
presuponer|to estimate, presuppose
presupuesto|budget
presuroso/a|hasty, quick
pretender|to try, court
pretensiones|pretensions
pretérito|past
pretexto|pretext
prevalecer|to prevail
prevenir|to prevent, warm
prevención\ciones|prevention
prevenido|prepared
prever|to anticipate, foresee
previo/via|previous
previsible|foreseeable
previsión\siones|foresight
prieto/a|dark, tight
primario/ria|primary
primavera|spring
primero/a|first
primitivo/a|primitive
primo/a|cousin
primogénito/a|first-born
primor|beauty
primordial|fundamental
primoroso/a|exquisite
princesa|princess
principado|principality
principal|principal
príncipe|prince
principio|beginning, principle
prioridad|priority
prisa|hurry, rush
prisión|prison
privar|deprive
privación\ciones|deprivation
privado/a|private
privativo/a|exclusive
privilegio|privilege
pro|for
proa|bow, prow
probabilidad|probability
probable|probable
probablemente|probably
probar|to prove, try, test
problema|problem
problemático/a|problematic
proceder|to proceed
procedencia|origin
procedimiento|procedure
procesar|to process, prosecute
procesador|processor
procesameinto|processing
procesión\siones|procession
proceso|process
proclamar|to proclaim
proclamación\ciones|proclamation
procrear|to procreate
procreación\ciones|procreation
procurar|to try, procure
prodigar|to lavish
prodigio|prodigy, wonder
prodigioso|prodigious
pródigo/a|prodigal
producir|to produce
producirse|to take place
producción\ciones|production
productivo/a|productive
producto|product
productor/tora|producer
proeza|feat, exploit
profanar|to desecrate, profane
profecía|prophecy
proferir|to utter
profesar|to profess
profesión\siones|profession
profesional|professional
profesor/sora|professor, teacher
profeta|prophet
profético/a|prophetic
profetizar|to prophesy
prófugo/a|fugitive
profundo/a|deep
profundamente|deeply
profundidad|depth
profundizar|to deepen
profuso/a|profuse
profusión\siones|profusion
programa|program
programación\ciones|programming
programador/dora|programmer
programar|to program
progreso|progress
progresión\ciones|progression
progresivo/a|progressive
prohibir|to prohibit
prohibición\ciones|prohibition
prohibido/a|prohibited
prójimo|fellow
prole|offspring
proletariado|proletariat
proliferar|to proliferate
prolífico/a|prolific
prolijo/a|tedious
prólogo|prologue
prolongar|to prolong, legthen
prolongación\ciones|extension
promedio|average
promesa|promise
prometer|to promise
prometido/a|promised, engagement, fiancé
prominente|prominent
promiscuo/cua|promiscuous
promiscuidad|promiscuity
promocionar|to promote
promoción\ciones|promotion
promover|to promote
promotor/tora|promoter
promulgar|to promulgate, proclaim
pronombre|pronoun
pronosticar|to predict, foretell
pronóstico|prognosis, prediction
pronto/a|soon, quick, prompt
pronunciar|to pronounce
pronunciarse|to declare oneself
pronunciación\ciones|pronunciation
propagación\ciones|propagation
propaganda|advertising
propagar|to propagate
propano|propane
propasarse|to go too far
propensión\siones|propensity, inclination
propenso/a|prone, inclined
propiamente|properly, exactly
propicio/cia|favorable, propitious
propiedad|property
propietario/ria|owner,proprietor
propina|tip
propio/pia|own
proponer|to propose, nominate
proporción\cioens|proportion
proporcionado/a|proportionated
proporcional|proportional
proposición\ciones|proposal, propposition
propósito|intention, purpose
propuesta|proposal, offer
propulsar|to drive, propel
prorrogar|to extend, postpone
prórroga|extension, deferment
prorrumpir|to burst forth, break out
prosa|prose
proseguir|to continue
prospecto|prospectus
prosperar|to prosper
prosperidad|prosperity
prostituir|to prostitute
prostitución|prostitution
prostituta|prostitute
protagonista|protagonist
protagonizar|star in
proteger|to protect
protección\ciones|protection
protector/tora|protective
protegido/a|protégé
proteína|protein
protestar|to protest
protestante|protestant
protocolo|protocol
prototipo|prototype
protuberancia|protuberance
protuberante|protuberant
provecho|benefit
provechoso/a|beneficial, profitable
proveer|to provide, supply
proverbio|proverb
providencia|providence
provincia|province
provisión\siones|provision
provisional|provisional
provocar|to cause
provocación\ciones|provocation
próximo/a|next
próximamente|soon
proyectar|to plan
proyección\ciones|projection
proyecto|project
proyector|projector
prudencia|prudence
prudente|prudent
prueba|test, proof, evidence
psicoanálisis|psychoanalysis
psicoanalista|psychoanalyst
psicoanalizar|to psychoanalyze
psicología|psychology
psicólogo/a|psychologist
psicópata|psychopath
psicosis|psychosis
psicoterapia|psycotherapy
psicoterapeuta|psychotherapist
psicótico/a|psychotic
psiquiatría|psychiatry
psiquiatra|psychiatrist
psiquiátrico|psychiatric
psíquico/a|psychic
púa|sharp, point
pubertad|puberty
publicar|to publish
publicación\ciones|publication
publicidad|publicity
publicista|publicist
publicitar|to publicize
publicitario/ria|advertising
público/a|public
puchero|stew
púdico/a|modest
pudiente|wealthy
pudín\dines|pudding
pudor|modesty
pudrir|to rot
pueblo|town
puente|bridge
puerco/a|pig
puerta|door
puerto|port
puertorriqueño/a|Puerto Rican
pues|then, since, because
puesta|sunset
puesto|position, place
pugnar|figth
pulcro/cra|tidy
pulga|flea
pulgada|inch
pulir|to polish
pulmón\mones|lung
pulmonía|pneumonia
pulpa|pulp
púlpito|pulpit
pulpo|octopus
pulsar|to press
pulsación\ciones|beat
pulsera|bracelet
pulso|pulse
pulverizar|to pulverize, spray
pulverizador|spray, atomizer
puma|puma
punta|tip, point
puntada|stitch
puntapié|kick
puntear|to pluck
puntería|aim
puntiagudo/a|sharp, pointed
puntilla|lace edging
punto|point
puntuación\ciones|score, punctuation
puntual|punctual
punzar|to prick
punzada|prick
punzante|sharp
puñado|handful
puñal|dagger
puño|fist
puñetazo|punch
pupila|pupil
pupitre|writing desk
puré|puree
pureza|purity
purga|purge
purgar|to purge
purgatorio|purgatory
purificar|to purify
puritano/a|puritanical
puro/a|pure
púrpura|purple
pus|ous
pusilánime|cowardly
puta|whore
putrefacción\ciones|rotting, putrefaction
que|that
qué|what
quebrar|to break
quebrarse|to break
quebrada|ravine, gorge
quebradizo/a|fragile
quebrado/a|broken
quebrantar|to break
quedar|to stay
quedarse|to stay
queja|complaint
quemar|to burn
quemarse|to burn oneself
quemado/a|burned
quemarropa|point-blank
querer|to want
querido/a|dear, darling
querosene|kerosene
querubín\bines|cherub
queso|cheese
quiebra|bankruptcy, break
quien|who
quién|who
quienquiera|whoever, whomever
quieto/a|quiet
quijada|jaw
quimera|illusion
química|chemistry
quince|fifteen
quinceañero/a|fifteen year old teenager
quincena|fortnight, two week period
quincenal|biweekly, twice a month
quincuagésimo/a|fiftieth
quinientos/tas|five hundred
quinta|villa, country house
quinteto/a|quintet
quinto/a|fifth
quiosco|kiosk
quiropráctico/a|chiropractor
quirúrgico/a|surgical
quisquilloso/a|fussy
quiste|cyst
quitar|to remove, take away
quizá|perhaps, maybe
rábano|radish
rabí|rabbi
rabia|rage
rabioso/a|rabid, enraged
rabino/a|rabbi
rabo|tail
racha|gust of wind
racimo|cluster, bunch
raciocinio|reason
ración\ciones|ration
racional|rational
racionalizar|to rationalize
racionar|to ration
racismo|racism
radar|radar
radiación\ciones|radiation
radiactivo/a|radioactive
radioactividad|radioactivity
radiofusión\siones|broadcast
radioemisora|radio station
radioescucha|listener
radiofónico/a|radio
radiografía|x-ray
radiología|radiology
ráfaga|gust, flash
raíz\ices|root
raja|crack, slit
rajar|to crack
rajarse|to crack
rallar|to grate
rama|branch
ramaje|branches
ramal|branch
ramificarse|to branch
ramillete|bouquet
rampa|incline
rana|frog
rancho|farm, ranch
ranchero|mrancher, farmer
rancio/cia|rancid
rango|rank
ranura|groove
rapar|to shave, crop
rapaz\paces|rapacious
rápido/a|rapid, quick
rápidamente|quickly, fast
rapidez|speed
rapsodia|rhapsody
raptar|to kidnap
raptor/tora|kidnapper
raqueta|racket
raro/a|rare
raramente|rarely
rareza|peculiarity, rarity
rascar|to scratch
rascarse|to scratch oneself
rasgar|to tear, rip
rasgo|characteristic, trait
rasguñar|to scratch
rasguño|scratch
raso/a|flat
raspar|to scrape
raspadura|scraping, scratch
rastra|rake
rastrear|to trace, track
rastrero/a|creeping
rastrillo|rake
rasurar|to shave
rata|rat
ratero/a|thief
ratificar|to ratify
ratificación\ciones|ratification
rato|short while
ratón\tones|mouse
raudal|torrent
raya|line
rayo|ray
rayón|rayon
raza|race
razón\zones|reason
razonable|reasonable
razonamiento|reasoning
razonar|to reason
reacción\ciones|reaction
reaccionar|to react
reaccionario|reactionary
reacio/cia|obstinate, stubborn
reactivar|to reactivate
reactor|jet
reajustar|to readjust
real|royal, real
realce|enhancement
realeza|royalty
realidad|reality
realismo|realism
realizar|to make, realize
realizarse|to fulfill oneself
realización\ciones|realization, accomplishment
realmente|really
realzar|to heighlight, enhance
reanimar|to reanimate, revive
reanudar|to renew
reaparecer|to reappear
rebajar|to reduce
rebanada|slice
rebaño|flock, hed
rebasar|to exceed
rebatir|to refute
rebelarse|to rebel
rebelde|rebel
rebelión\liones|rebellion
rebobinar|to rewind
rebosar|to overflow
rebotar|to bounce
rebote|bounce
rebozar|to coat in batter
rebuscado/a|searched carefully
recado|message
recaer|to fall on, relapse
recaída|relapse
recalcar|to stress, emphasize
recalentar|to overheat
recámara|firing chamber, bedroom
recambio|spare part
recapitular|to recapitulate
recapitulación\ciones|recapitulation
recargar|to recharge, overload
recatado/a|modest, demure
recaudar|to collect
recaudación\cciones|collection
recaudador/dora|collector
recepción\ciones|reception
recepcionista|receptionist
receptivo/a|receptive
receptor|receiver
recesión\siones|recession
receso|recess
receta|recipe
rechazar|to reject
recibir|to receive
recibidor|vestibule
recibimiento|reception
recibo|receipt
reciclar|to recycle
reciclaje|recycling
recién|just, recently
reciente|recent
recientemente|recently
recio/cia|strong
recipiente|container
recíproco/a|reciprocal
recitar|to recite
recital|recital
reclamar|to protest
reclamación\ciones|claim
reclamo|reclamation, lure
reclinar|to lean
recluir|to shut in, confine
reclusión\siones|imprisonment
recluso/a|prisoner
recluta|recruit
reclutamiento|recruitment
recobrar|to recover
recodo|bend
recoger|to gather, pick up
recogedor|dustpan
recogido/a|gathered, secluded
recolección\ciones|harvesting, collection
recomendar|to recommend
recomendación\ciones|recommendation
recompensar|to compensate, reward
recompensa|reward
reconciliar|to reconcile
reconciliación\ciones|reconciliation
recóndito/a|recondite, hidden
reconfortar|to comfort
reconocer|to recognize
reconocido/a|recognized
reconocimiento|recognition
reconsiderar|to reconsider
reconstruir|to reconstruct
reconstrucción\ciones|reconstruction
recopilar|to compile, collect
recopilación\ciones|compilation
récord\cords|record
recordar|to remember, remind
recordatorio|reminder
recorrer|to cross, travel through
recorrido|route, journey, trip
recortar|to trim, cut
recrear|to recreate, entertain
recrudecer|to worsen
rectángulo|rectangle
rectangular|rectangular
rectificar|to rectify
rectitud|straightness, rectitude
recto/a|rectum, straight
rector/tora|director, rector
rectoría|rectory
recubrir|to cover
recuento|count, recount
recuerdo|memory, remembrance
recuperar|to recover
recuperarse|to recover
recuperación\ciones|recovery
recurrir|to resort to, turn to
red|network, net
redactar|to write up
redacción\ciones|writing
redactor/tora|editor
redescrubrir|to rediscover
redención\ciones|redemption
redoblar|to redouble
reducir|to reduce
reducción\ciones|reduction
redundante|redundant
redundancia|redundancy
reedición\ciones|reprint
reembolsar|to reimburse, refund
reemplazar|to replace
reencarnación\ciones|reincarnation
reencuentro|encounter, reunion
reestructurar|to restructure
refaccionar|to repair, renovate
refacciones|repairs
referir|to refer
referéndum|referendum
referente|referring, concerning
refinar|to refine
refinado/a|refined
refinamiento|refinement
refinería|refinery
reflector|reflector
reflejar|to reflect
reflejarse|to be reflected
reflejo|reflection
reflexionar|to reflect, think
reflexión\xiones|reflection
reflexivo/a|reflexive
reforma|reform
reformador/dora|reformer
reformar|to reform
reformatorio|reformatory
reforzar|to reinforce
refrán\franes|proverb
refregar|to scrub
refrenar|to rein in
refrendar|to aprove
refrescar|to refresh, cool
refrescante|refreshing
refresco|soft drink
refriega|scuffle
refrigeración\ciones|refrigeration
refrigerio|refreshment
refuerzo|reinforcements
refugiar|to shelter
refugiarse|to take refuge
refugiado/a|refugee
refulgir|to shine, brightly
refunfuñar|to grumble, groan
regadera|watering can
regalar|to give
regalo|gift, present
regañadientes|reluctantly, unwillingly
regañar|to scold
regañon/ñona|grumpy, irritable
regar|to water
regatear|to haggle, bargain
regazo|lap
regenerar|to regenerate
régimen|regime
regimiento|regiment
regio/gia|regal
región\giones|region
regir|to prevail, rule
registrar|to register
registrador/dora|register
registro|registration
regla|rule
reglamentación\ciones|regulation
reglamentar|to regulate
reglamentario/ria|regulation
reglamento|regulations
regocijar|to cheer, gladden
regocijo|rejoicing, delight
regordete|chubby
regresar|to return, come back
regresión\siones|regression
regresivo/a|regressive
regreso|return
regular|regular, to regulate
regulación\ciones|regulation
rehabilitar|to rehabilitate
rehabilitación\ciones|rehabilitation
rehén\henes|hostage
reimprimir|to reprint
reimpresión\siones|reprinting
reina|queen
reinado|reign
reinante|reigning
reinar|to reign
reincidir|to backslide
reino|kingdom
reintegrar|to refund, reinstate
reintegro|reimbursement, refund
reír|to laugh
reírse|to laugh
reiterar|to reiterate
reinvindicar|to restor
reja|grate, grille
rejuvenecer|to rejuvenate
rejuvenecerse|to be rejuvenated
relación\ciones|relation
relacionar|to relate
relajar|to relax
relajarse|to relax
relajación\ciones|relaxation
relajado/a|relaxed
relámpago|lightning
relampaguear|to flash
relatar|to relate, tell
relativo/a|relative
relato|story
relevante|important
relevar|to relieve
relevo|relief
relieve|relief
religión\giones|religion
religioso/a|religious
reliquia|relic
rellenar|to refill
reloj|clock
relucir|to shine, glitter
relumbrar|to shine brightly
remanente|remainder
remar|to row
rematar|to end, finish off
remedar|to imitate
remediar|to remedy, repair
remendar|to mend
remesa|remittance
remisión\siones|remission
remiso/a|reluctant
remitir|to send, remit
remitente|sender
remo|oar, paddle
remodelar|to remodel
remojar|to soak
remolacha|beet
remolcar|to tow
remolino|whirlwind
remolque|tow
remontar|to overcome
remordimiento|remorse
remoto/a|remote
remunerar|to remunerate
renacer|to be reborn
renacimiento|rebirth
renacuajo|tadpole
rencilla|quarrel
rencor|rancor
rencoroso/a|resentful
rendición\ciones|surrender
rendido/a|submissive, exhausted
rendir|to render, to yield
rendirse|to surrender
rendimiento|yield, performance
renegar|to deny, grumble
renegado/a|renegade
renglón\glones|line
reno|reindeer
renombre|reputation, renown
renombrado/a|famous, renowned
renovar|to renew
renovación\ciones|renewal, renovation
rentar|to rent
renunciar|to resign, renounce
renuncia|renunciation
reo/rea|accused
reorganizar|to reorganize
reparar|to repair
reparación\ciones|reparation
reparo|objection
repartir|to distribute
repartición\ciones|distribution
repartidor/dora|delivery person, distributor
reparto|delivery, distribution
repasar|to review
repeler|to repel
repertorio|repertoire
repetir|to repeat
repleto/a|replete, full
replicar|to reply
réplica|reply
repollo|cabbage
reponer|to replace
reportar|to report
reportaje|article
reporte|report
reposar|to rest
reposado/a|rested, calm
reposición\ciones|replacement
representar|to represent
representación\ciones|representation
representativo/a|representative
represión\siones|repression
reprimir|to repress
reprobar|to reprove
reproducir|to reproduce
reproducción\ciones|reproduction
reproductor/tora|reproductive
república|republic
repuesto|spare part
repugnar|to disgust
repulsivo/a|repulsive
reputar|to consider, deem
requerir|to require
requesón\sones|cottage cheese
requisito|requirement
res|beef
resaca|undertow
resbalar|to slip
resbaladizo/a|slippery
resbalón\lones|slip
resbaloso/a|slippery
rescatar|to rescue
rescate|rescue
rescisión\siones|cancellation
resecar|to dry
resecarse|to dry up
reseco/a|dry
resentirse|to suffer
resentimiento|resentment
reserva|reserve
reserva|reservation
reservación\ciones|reservation
reservado/a|reserved
resfriar|to cool
residencia|residence
residuo|remainder
resignar|to resign
resignación\ciones|resignation
resina|resin
resistir|to resist
resistencia|resistance
resolver|to solve
resolución\ciones|resolution
resonancia|resonance
resorte|spring
respectivo/a|respective
respetar|to respect
respeto|respect
respetuoso/a|respectful
respirar|to breathe
respiración\ciones|breathing, respiration
respiratorio/ria|respiratory
respiro|breath
resplandecer|to shine
resplandeciente|shining
resplandor|brilliance
responder|to answer
responsable|responsible
responsabilidad|responsibility
respuesta|answer
resta|subtraction
restablecer|to restore
restablecerse|to recover
restablecimiento|restoration
restar|to reduce, subtract
restante|rest, remaining
restauración\ciones|restoration
restaurante|restaurant
restaurar|to recover
restituir|to restore
restitución\ciones|restitution
resto|rest
restringir|to restrict
restricción\ciones|restriction
resucitar|to resuscitate, revive
resuelto/a|determined, resolved
resumir|to summarize
resumen\súmenes|summary
resurgir|to reappear
resurgiomiento|resurgence
resurrección\ciones|resurrection
retardar|to delay
retazo|piece, scrap
retener|to keep
retención\ciones|retention
retina|retina
retirar|to remove
retirarse|to retreat
retirada|withdrawal
retirado/a|retired, secluded
reto|challenge
retocar|to touch up
retorcer|to twist
retorcimiento|twisting
retornar|to return
retractarse|to withdraw
retraer|to retract
retraído/a|withdrawn, dissuaded
retrasar|to delay
retrasado/a|delayed
retraso|delay
retratar|to portray
retrato|picture
retribuir|to pay
retribución\ciones|payment
retroactivo/a|retroactive
retroceder|to go back
reumatismo|rheumaism
reunir|to unite, join
reunión\niones|meeting
revancha|rvenge
revelar|to reveal
revelación\ciones|revelation
revelado|revealed, developing
revelador/dora|revealer
reventar|to burst, blow up
reventarse|to burst
reverenciar|to revere
reverencia|reverence, bow
reverendo/a|reverend
reverente|reverent
reversa|reverse
revertir|to revert
revés\veses|back
revisar|to review
revisión\siones|revision
revisor/sora|inspector
revista|magazine
revivir|to revive
revocar|to revoke
revolcar|to knock over
revolcarse|to roll around
revoltijo|jumble
revoltoso/a|rebellious
revolución\ciones|revolution
revolucionar|to revolutionize
revolucionario/ria|revolutionary
revolver|to mix
revólver|revolver
rey|king
rezar|to pray
riachuelo|brook
rico/a|rich
ridiculizar|to ridicule
riel|rail
rienda|rein
riesgo|risk
rifa|raffle
rifar|to raffle
rifarse|to figth over
rifle|rifle
rígido/a|rigid
rigor|rigor
rima|rhyme
rímel|mascara
rincón\cones|corner
rinoceronte|rhinoceros
riña|fight
riñón\ñones|kidney
río|river
riqueza|wealth
risa|laughter
risco|crag
risueño/a|cheerful, smiling
ritmo|rhythm
rítmico/a|rythmical
rito|rite
ritual|ritual
rival|rival
rivalidad|rivalry
rivalizar|to compete with
rizar|to curl
rizarse|to curl
rizado/a|curled
rizo|curl
robar|to rob, steal
robo|robbery, theft
robot\bots|robot
robótica|robotics
roca|rock
rociar|to spray, sprinkle
rocoso/a|rocky
rodaja|slice
rodar|to roll
rodilla|knee
rodillo|roller
rogar|to request
rojo/a|red
rojizo/a|reddish
rollizo/a|plump
rollo|roll
romance|romance
romano/a|roman
romántico/a|romantic
romanticismo|romanticism
romero|rosemary
rompecabezas|puzzle
romper|to break
romperse|to break
ron|rum
ronquera|hoarseness
ronquido|snore
ronronear|to purr
ropa|clothes
ropaje|robes
ropero|closet, wardrobe
rosa|rose
rosado/a|pink
rosal|rosebush
rosario|rosary
rosbif|roast beef
roseta|rosette
rosquilla|doughnut
rostro|face
rotación\ciones|rotation
rotativo/a|rotary
roto/a|broken
rotonda|traffic circle
rotura|break
rubí\rubíes|ruby
rubio/bia|blonde
rubor|flesh, bush
ruborizarse|to blush
rudeza|roughness
rudimientos|rudiments
rudimentario/ria|rudimentary
rudo/a|rough
rueda|wheel
ruego|request
rugir|to roar
rugido|roar
ruido|noise
ruidoso/a|noisy
ruina|ruin
ruinoso/a|run-down
ruiseñor|nightingale
ruleta|roulette
rulo|roller, curler
rumano/a|rumanian
rumba|rumba
rumbo|course
rumiar|to mull over
rumiante|ruminant
rumor|rumor
rumoroso/a|murmuring
ruptura|rupture
rural|rural
ruso/a|russian
rústico/a|rural, rustic
ruta|rute
rutina|routine
sábado|saturday
sábana|sheet
sabandija|insect, bug
saber|to know
sabor|flavor
saborear|to savor
sabotaje|sabotage
saboteador/dora|saboteur
sabotear|to sabotage
sabroso/a|delicious, tasty
sabueso|bloodhound
sacacorchos|corkscrew
sacapuntas|pencil sharpener
sacar|to remove, take out
sacarina|saccharin
sacerdote/tisa|priest/priestess
sacerdocio|priesthood
sacerdotal|priestly
saciar|to satisfy
saco|coat, bag
sacramento|sacrament
sacramental|sacramental
sacrificar|to sacrifice
sacrificarse|to sacrifice oneself
sacrificio|sacrifice
sacrilegio|sacrilege
sacrílego/a|sacrilegious
sacro/cra|sacred
sacrosanto|sacrosanct
sacudir|to shake
sacudirse|to shake off
sacudida|shock, shaking
sádico/a|sadistic
sadismo|sadism
saeta|arrow
safari|safari
sagrado/a|sacred, holy
sal|salt
sala|room, living room
salar|to salt
salado/a|salty
salario|salary
salchicha|sausage
salchichón\chones|salami
salero|saltshaker
salir|to leave, go out
saliva|saliva
salmo|psalm
salmón\mones|salmon
salón\lones|hall, room
salpicar|to splash
salpicadera|fender
salpicadura|splash
salsa|sauce
saltamontes|grasshopper
saltar|to jump
saltear|to skip
salto|jump
salud|health
saludable|healthful
saludar|to greet, salute
saludo|greeting
salvación\ciones|salvation
salvado|bran
salvador/dora|savior, rescuer
salvadoreño/a|salvadoran
salvaguardar|to safeguard
salvaje|savage, wild
salvar|to save, rescue
salvavidas|life-guard
salvo/a|safe, save
samba|samba
sanar|to heal, cure
sanatorio|sanatorium
sanción\ciones|sanction
sancionar|to sanction
sandalia|sandal
sandía|watermelon
sandwich\wiches|sandwich
saneamiento|sanitation
sangrar|to bleed
sangrante|bleeding
sangre|blood
sangriento|bloody
sanguinario/ria|bloodthirsty
sanguíneo/nea|sanguineous
sano|healthy
sanidad|health
sanitario|toilet
santo/a|holy
sapo|toad
saque|serve (tennis), throw-in (soccer)
saquear|to sack
sarampión|measles
sarcasmo|sarcasm
sarcástico/a|sarcastic
sardina|sardine
sargento|sergeant
sarpullido|rash
sartén\tenes|frying pan
sastre|tailor
sastrería|tailoring
satanás|satan
satánico/a|satanic
satélite|satellite
sátira|satire
satírico/a|satirical, satirist
satisfacer|to satisfy
satisfacción\ciones|satisfaction
satisfactorio/ria|satisfactory
satisfecho/cha|satisfied
saturar|to saturate
saturno|saturn
sauna|sauna
saxofón\fones|saxophone
sazón\zones|seasoning
sazonar|to season
se|himself, herself, itself, oneself, yourself, yourselve, themselves
sebo|tallow, fat
secar|to dry
secador|hair dryer
secadora|dryer
sección\ciones|section
seco/a|dry
secretar|to secrete
secreción\ciones|secretion
secretario/ria|secretary
secretaría|secretariat
secreto/a|secret
secta|sect
sector|sector
secuaz\cuaces|partisan, henchman
secuela|sequel
secuencia|sequence
secuestrar|to kidnap
secuestrador/dora|kidnapper
secuestro|kidnapping
secular|secular
secundar|to secundar
secundario/ria|secondary
sed|thirst
seda|silk
sedal|fishing line
sedar|to sedate
sede|seat
sedentario/ria|sedentary
sedicioso/a|seditious
sedimento|sediment
sedoso/a|silky
seducir|to seduce
seducción\ciones|seduction
seductor/tora|seductive
segmento|segment
segregar|to segregate
segregación\ciones|segregation
seguir|to follow
seguido/a|continuous, consecutive
seguidor/dora|follower
según|according to
segundo|second
seguro/a|safe
seguramente|surely
seguridad|security
seis|six
seiscientos/tas|six hundred
selección\ciones|selection
seleccionar|to select
selectivo/a|selective
selecto/a|select
sellar|to seal
selva|forest, jungle
semáforo|traffic light
semana|week
semanal|weekly
semanario|weekly
semántica|semantics
semántico|semantic
semblante|countenance, look
sembrar|to sow
semen|semen
semental|stud, stallion
semestre|semester
semifinal|semifinal
semilla|seed
seminario|seminary
sémola|semolina
senado|senate
senador/dora|senator
sencillo/lla|simple
sencillez|simplicity
senda|path, way
senil|senile
seno|breast, sinus
sensación\ciones|sensation, feeling
sensacional|sensational
sensacionalista|sensationalistic
sensato/a|sensible
sensatez|good sense
sensible|sensitive
sensibilidad|sensitivity
sensitivo|sense
sensual|sensual
sensualidad|sensuality
sentar|to seat, sit
sentarse|to sit (down)
sentado/a|seated, sitting
sentencia|sentence
sentido/a|heartfelt,sense
sentimiento|feeling
sentimental|sentimental
sentimentalismo|sentimentality
sentir|to feel
seña|sign
señal|signal
señor/ñora|sir/madam
señorita|miss
señuelo|decoy
separar|to separate
septiembre|september
séptimo/a|seventh
sepulcro|tomb
sepultar|to bury
sepultura|grave, burial
sequedad|dryness
sequía|drought
ser|to be
serenar|to calm
serenarse|to calm down
serenata|serenade
serenidad|serenity
sereno/a|serene, night watchman
serie/ria|series
seriedad|seriousness
sermón\mones|sermon
sermonear|to preach
serpiente|serpent, snake
serrano/a|mountain
servicio|service
servilleta|napkin
servir|to serve
sesenta|sixty
sesión\siones|session
seso|brain
seta|mushroom
setecientos/tas|seven hundred
setenta|seventy
seudónimo|pseudonym
severo/a|severe, harsh
sexágesimo/a|sixtieth
sexo|sex
sexista|sexist
sexteto|sextet
sexto/a|sixth
sexual|sexual
sexualidad|sexuality
sexy|sexy
si|if, yes
sida|aids
sidra|cider
siembra|sowing
siempre|always
sien|temple
sierra|mountain range
siervo/a|servant, slave
siesta|siesta
siete|seven
sífilis|syphilis
sigla|abbreviation
siglo|century
significar|to mean
significación\ciones|meaning, significance
significado|meaning
significativo/a|significant
signo|sign
siguiente|following, next
sílaba|syllable
silbar|to whistle
silbato|whistle
silbido|whistle
silenciar|to silence
silenciador|muffler
silencio|silence
silencioso/a|quiet, silent
silicio|silicon
silla|chair
silo|silo
silueta|silhouette
silvestre|wild
símbolo|symbol
simbólico/a|symbolic
simbolismo|symbolism
simbolizar|to symbolize
simetría|symmetry
simétrico/a|symmetrical
simiente|seed
símil|simile
similar|similar
simio|ape
simpatía|affection, liking
simpático/a|likeable
simpatizante|sympathizer
simple|simple
simpleza|simpleness
simplicidad|simplicity
simplificar|to simplify
simposio|symposium
simular|to simulate
sumltáneo/nea|simultaneous
sin|without
sinagoga|synagogue
sincero/a|sincere
sinceramente|sincerely
sinceridad|sincerity
sincronizar|to synchronize
sindicato|union (labor)
sindical|union (labor)
síndrome|syndrome
sinfonía|symphony
singular|exceptional
singularizar|to distinguish, single out
siniestro/tra|sinister
sino|but, rather
sinónimo|synonymous
sinopsis|synopsis
sinrazón\zones|wrong
síntaxis|syntax
síntesis|synthesis
síntoma|symptom
sintonía|syntony
sinuoso/a|winding
sinverguenza|scoundrel
siquiera|at least
sirio/ria|syrian
sirviente/a|servant
sismo|earthquake
sísmico/a|seismic
sistema|system
sistemático/a|systematic
sitio|place, site
situar|to locate
situarse|to be located
situación\ciones|situation
situado/a|located, placed
smoking|tuxedo
so|under
soberanía|sovereignty
soberano/a|sovereign
soberbia|pride
soberbio/bia|proud
sobornar|to bribe
sobrar|to exceed
sobra|surplus
sobrado/a|exceeded
sobrante|remaining
sobre|envelope, on
sobrecama|bedspread
sobrecargar|to overload
sobredosis|overdose
sobreentender|to understand
sobreentenderse|to be understood
sobreestimar|to overestimate
sobrellevar|to bear, endure
sobremesa|tablecloth
sobrenatural|supernatural
sobrenombre|nickname
sobrepasar|to exceed
sobreponer|to superpose
sobresalir|to stand out
sobresaliente|outstanding
sobresaltar|to startle
sobresalto|fright
sobretodo|overcoat, coverall
sobrevenir|to happen
sobrevivir|to survive
sobrevolar|to fly over
sobriedad|sobriety
sobrino/a|nephew/niece
sobrio/bria|sober
sociable|sociable
social|social
socialismo|socialism
socialista|socialist
sociedad|society
sociología|sociology
sociólogo/a|sociologist
socorrer|to help
socorrista|lifeguard
socorro|help
soda|soda water
sodio|sodium
sofá|sofa
sofisticación\ciones|sophistication
sofisticado/a|sophisticated
sofocar|to suffocate
sofocarse|to suffocate
sofocante|suffocating
soga|rope
sojuzgar|to subjugate
sol|sun
solamente|only
solapa|lapel
solar|to solar
soldado|soldier
soldar|to weld
soleado/a|sunny
soledad|loneliness, solitude
solemne|solemn
solicitar|to solicit, request
solicitante|applicant
solícito/a|solicitous
solicitud|request, application
solidaridad|solidarity
sólido/a|solid
solidez|solidity
solidificar|to solidify
solidificarse|to solidify
solista|soloist
solitario/ria|solitary, loleny
sollozar|to sob
sollozo|sob
solo/a|alone
sólo|only
solsiticio|solstice
soltar|to drop
soltero/a|single, unmarried
solución\ciones|solution
solucionar|to solve
solventar|to resolve, settle
solvente|reliable, solvent
sombra|shadow
sombreado/a|shady
sombrero|hat
sombrilla|umbrella
sombrío/bría|shady, dark
someter|to subjugate
sonajero|rattle
sonámbulo/a|sleepwalker
sonar|to sound
sonata|sonata
soneto|sonnet
sonido|sound
sonoro/a|sonorous
sonreír|to smile
sonriente|smiling
sonrisa|smile
sonrojarse|to blush
soñar|to dream
soñador/dora|dreamer
soñoliento/a|sleepy
sopa|soup
soplar|to blow
soplete|blowpipe
soplo|blowing
soplón/plona|sneak
soportar|to support, bear
soprano|soprano
sor|sister
sordera|deafness
sórdido/a|squalid
sordo/a|deaf
sorprender|to surprise
sorprenderse|to be surprised
sorprendente|surprising
sorpresa|surprise
sortear|to draw for
sorteo|drawing
sortija|ring
sosegar|to calm
sosegado/a|calm
sospechar|to suspect
sospecha|suspicion
sospechoso/a|suspect
sostener|to maintain, support, hold
sostén\tenes|support, brassiere
sostenido/a|sustained
sótano|basement
soviético/a|soviet
soya|soy
sr|mr.
sra|mrs.
srta|miss
su|his
suave|smooth
suavidad|smoothness
suavizar|to smooth
subalterno/a|subordinate
subasta|auction
subcampeón\peones|runner-up
subcomité|subcommittee
subdirector/tora|assistant director
súbdito/a|subject
subdividir|to subdivide
subdivisión\siones|subdivision
subestimar|to underestimate
subir|to raise
subirse|to rise
subida|ascent
subido/a|raised
súbito/a|sudden
subjetivo/a|subjective
subjuntivo/a|subjunctive
sublevar|to stir up
sublevarse|to rebel
sublevación\cioens|uprising
sublime|sublime
submarino|submarine
submarinismo|scuba diving
subordinar|to subordinate
subordinado/a|subordinate
subproducto|by-product
subrayar|to underline
subsanar|to rectify
subsidio|subsidy
subsigueinte|subsequent
subsistir|to subsist
subterráneo/nea|subterranean
subtítulo|subtitle
suburbio|suburb
suburbano/a|suburban
subersión\siones|subversion
subversivo/a|subversive
subyacente|underlying
subyugar|to subjugate
suceder|to happen/ occur
sucesión\siones|succession
sucesivo/a|successive
suceso|event
sucesor/sora|successor
suciedad|dirtiness
sucio/cia|dirty
suculento/a|succulent
sucursal|branch
sudafricano/a|south African
sudamericano/a|south American
sudar|to sweat
sudor|sweat
sudoroso/a|sweaty
sueco/a|swedish
suegro/gra|father-in-law / mother-in-law
suegros|in-laws
suela|sole
suelto/a|loose
sueño|dream
suero|serum
suerte|luck
suéter|sweater
suficiencia|competence
suficiente|enough
suficientemente|enough
sufijo|suffix
sufragio|suffrage
sufrir|to suffer
sufrido/a|suffered
sufrimiento|suffering
sugerir|to suggest
sugerencia|suggestion
sugestión\tiones|suggestion
sugestivo/a|suggestive
suicidio|suicide
suicida|suicidal
suicidarse|commit suicide
suite|suite
suizo/a|swiss
sujetar|to hold
sujetapapeles|paper clip
sulfuro|sulfur
sultán\tanes|sultan
suma|sum
sumamente|extremely
sumar|to add
sumario|summary
sumergir|to submerge
sumergirse|be submerged
sumergible|waterproof
suministrar|to supply
suministro|supply
sumisión\siones|submission
sumiso/a|submissive
sumo/a|highest
superabundancia|superabundance
superar|to surpass
superarse|improve oneself
superávit|surplus
superestructura|superstructure
superficie|surface
superficial|superficial
superfluo/flua|superfluous
superintendente|superintendent
superior|superior
superioridad|superiority
superlativo/a|superlative
supermercado|supermarket
superpoblado/a|over-populated
supersónico/a|supersonic
supersticioso/a|superstitious
supervisar|to supervise
supervisión\siones|supervision
supervisor/sora|supervisor
superviviencia|survival
superviviente|survivor
suplemento|supplement
suplementario|supplementary
suplente|substitute
suplicar|to beg
súplica|slea
suplir|to replace
suponer|to suppose
suposición\ciones|supposition
supositorio|suppository
supremo/a|supreme
supremacía|supremacy
suprimir|to suppress
supresión\siones|suppression
supuesto/a|supposed
sur|south
sureño/a|southern
sureste|southeastern
surf|surfing
surgir|to arise
surgimiento|rise
suroeste|southwest
surtir|to supply
surtido/a|varied
surtidor|pas pump
susceptible|susceptible
susceptibilidad|susceptibility
suscitar|to provoke
suscribir|to subscribe
suscripción\ciones|subscription
suscritor/tora|subscriber
suspender|to suspend
suspensión\siones|sussuspension
suspenso|suspense
suspicaz\caces|suspicious
suspirar|to sigh
suspiro|sigh
sustancia|substance
sustancial|substantial
sustancioso/a|substantial
sustantivo|noun
sustentar|to support
sustentarse|to support oneself
sustentación\ciones|support
sustento|sustenance
sustituir|to replace
sustitución\ciones|substitution
sustituto/a|substitute
susto|scare
sustraer|to remove
sustracción\ciones|subtraction
susurrar|to whisper
susurro|whisper
sutil|delicate
sutileza|subtlety
sutura|suture
suyo/a|his, her, its
switch|switch
tabaco|tobacco
taberna|tavern
tabla|board
tablero|board
tableta|tablet
tablilla|slat
tablón\blones|plank
tabú|taboo
tabular|tabulate
tacaño/a|stingy
tacha|flaw
tachar|to cross out
tachón\chones|stud
tácito\ta|tacit
taciturno/a|taciturn
taco|heel
tacón\cones|heel
táctica|tactics
tailandés/desa|thai
tajar|to slice
tajada|slice
tajante|categorical
tal|so
taladrar|to drill
taladro|drill
talco|talcum powder
talento|talent
talentoso/a|talented
talismán\manes|talisman
talla|size
tallarín\rines|noodle
taller|workshop
tallo|stem, stalk
talón\lones|heel
tamal|tamale
tamaño|size
tambalearse|to stagger
también|also, too
tambor|drum
tampoco|neither
tampón\pones|tampon
tan|so
tangente|tangent
tangible|tangible
tango|tango
tanque|tank
tantear|to grope
tanto/a|so much
tapa|cover
tapar|to cover
tapadera|cover
tapete|rug
tapicería|tapestry
tapiz\pices|carpet
tapizar|to upholster
tapón\pones|cork
taquigrafía|stenogrphy
taquígrafo/a|stenographer
taquilla|ticket office
tarántula|tarantula
taratear|to hum
tardar|to take a long time
tardanza|lateness
tarde|late
tardo/a|slow
tarea|homewrok
tarifa|fare, rate
tarima|platform
tarjeta|card
tarro|jar
tarta|cake
tasca|bar
tatuar|to tattoo
tatuaje|tattoo
taxi|taxi
taxista|taxi driver
taza|cup
tazón\zones|bowl
té|tea
teatro|theater
teatral|theatrical
techo|ceiling
techumbre|roofing
tecla|key
teclado|keyboard
técnica|technique
técnico/a|technician
tecnología|technology
tecnológico/a|technological
tedioso/a|tedious
teja|tile
tejado|tile roof
tejer|to weave
tejido|weave
tela|fabric
telar|loom
telaraña|spiderweb
tele|tv, television
telecomunicación\ciones|telecommunication
teledirigido/a|remoted-control
telefonear|to telephone
telefónico/a|telephone
telefonista|operator
teléfono|telephone
telegrafiar|to telegraph
telegráfico/a|telegraphic
telégrafo|telegraph
telegrama|telegram
telenovela|soap opera
telepatía|telepathy
telepático/a|telepathic
telescopio|telescope
telescópico/a|telescopic
telesquí|ski lift
televidente|viewer
televisión\siones|television
televisar|to televise
televisor|television set
telón\lones|drop curtain
tema|theme
temblar|to shake
temblor|tremor
tembloroso/a|trembly
temer|to fear
temerario/ria|reckless
temeridad|recklessness
temeroso/a|afraid
temor|fear
temperamento|temperament
temperamental|temperamental
temperatura|temperature
tempestad|storm
tempestuoso/a|stormy
templar|to warm up
templaza|moderation
templo|temple
temporada|season
temporal|weather
temporizador|timer
temprano/a|early
tenaz\naces|tenacious
tenaza|pliers
tendedero|clothesline
tendencia|tendency
tender|to strech out
tenderse|to lie down
tendero/a|shopkeeper
tendido|laying
tendón\dones|sinew
tenebroso/a|tenebrous
tenedor|fork
tener|to have
tenia|tapeworm
teniente|lieutenant
tenis|tennis
tenista|tennis player
tenor|tenor
tensión\siones|tension
tentación\ciones|temptation
tentáculo|tentacle
tentar|to tempt
tentador/dora|tempter
tentativa|attempt
tenue|tenuous
teñir|to dye
teología|theology
teólogo/a|theologian
teorema|theorem
teoría|theory
teórico/a|theoretical
tequila|tequila
terapia|therapy
terapeuta|therapist
terapéutico/a|therapeutic
tercermundista|third-world
tercero/a|third
terciar|to sling
tercio|third
terciopelo|velvet
terco/a|stubborn
tergiversar|to distort
terminar|to finish
terminación\ciones|termination, conclusion
terminal|terminal
término|term
terminología|terminology
termita|thermite
termo|thermos
termómetro|thermometer
termóstato|thermostat
ternero/a|bull calf
ternura|tenderness
terquedad|stubborness
terracota|terra-cotta
terrateniente|landowner
terraza|terrace
terremoto|earthquake
terreno|land
terrible|terrible
territorio|territory
terrón\rones|lump
terror|terror
terrorífico/a|terrifying
terrorismo|terrorism
terrorista|terrorist
terso/a|smooth
tersura|smoothness
tesis|thesis
tesoro|treasure
testaferro|figurehead
testamento|testament
testículo|testicle
testificar|to testify
testigo|witness
testimoniar|to testify
testimonio|testimony
tétano|tetanuz
tetera|teapot
tetilla|nipple
tétrico/a|gloomy
textil|textile
texto|text
textual|textual
textura|texture
tez\teces|complexion
ti|you
tibio/bia|lukewarm
tiburón\rones|shark
tic|tic
tiempo|time
tienda|store
tierno/a|tender
tierra|earth
tieso/a|rigid
tifoidea|typhoid fever
tifón\fones|typhoon
tigre/gresa|tiger
tijera|scissors
tilde|accent mark
timar|to swindle
timbre|bell
timbrar|to stamp
tímido/a|shy
timidez|timidity
timón\mones|rudder
tímpano|eardrum
tina|bathtub
tinieblas|darknesses
tinta|ink
tintero|inkpot
tintinear|to jingle
tinto/a|dyed
tintorería|dry cleaner
tintura|tint
tío/tía|uncle / aunt
típico/a|typical
tipo/a|guy
tipografía|typography
tipográfico/a|typographical
tipógrafo/a|printer
tíquet|ticket
tira|strip
tirabuzón\zones|corkscrew
tirada|throw
tirador/dora|gunner
tiranía|tyranny
tiránico/a|tyrannical
tirano/a|tyrant
tirante|taut
tirar|to throw
tiritar|to shiver
tiro|shot
tiroides|thyroid
tirón\rones|pull
títere|puppet
titilar|to flicker
titireto/a|puppeteer
titubear|to hesitate
titubeante|hesitant
titubeo|hesitation
titular|to title
titularse|to be titled, receive a degree
título|title
tiza|chalk
tiznar|to blacken
toalla|towel
tobillo|ankle
tobogán\ganes|toboggan
tocadiscos|record player
tocado/a|hairdo, touched
tocador|dressing table
tocar|to touch
tocayo/a|namesake
tocino|bacon
todavía|still
todo/a|everything
todos/das|all
todopoderoso/a|almighty
toga|toga
toldo|awning
tolerar|to tolerate
tolerancia|tolerance
tolerante|tolerant
toma|capture
tomar|to take, to drink
tomate|tomato
tomo|volume
tonada|tune
tonelada|ton
tónica|tonic
tónico|tonic
tontería|triviality
tonto/a|silly
topacio|topaz
tope|limit
tópico/a|topic
topo|mole (animal)
toque|touch
tórax|thorax
torbellino|whirlwind
torcer|to twist
torcerse|to twist
torcedura|twisting
torcido/a|twisted
torear|to goad
torero/a|bullfigther
tormenta|storm
tormentoso/a|stormy
tornado|tornado
torneo|match
tornillo|screw
torniquete|tourniquet
torno|winch
toro|bull
toronja|grapefruit
torpe|clumsy
torpedo|torpedo
torpeza|stupidity
torre|tower
torrente|torrent
torrencial|torrential
torta|cake
tortícolis|stiff neck
tortilla|tortilla
tórtola|turtledove
tortuga|turtle
tortuoso/a|winding
tortura|torture
torturar|to torture
tos|cough
tosco/a|rough
toser|to cough
tosquedad|coarseness
tostar|to toast
tostada|toasted
tostador|toaster
total|total
totalidad|totality
tóxico/a|toxic, poison
toxina|toxin
traba|obstacle
trabajar|to work
trabajador/dora|worker
trabajoso/a|arduous
trabalengua|tongue twister
trabar|to join
trabarse|to jam
tracción\ciones|traction
tractor|tractor
tradicción\ciones|tradition
tradicional|traditional
traducir|to translate
traducción\ciones|translation
traductor/tora|translator
traer|to bring
traficante|dealer
tráfico|traffic
tragaluz\luces|skylight
tragar|to swallow
tragedia|tragedy
trago|drink
tragón\gones|greedy
traicionar|to betray
traición\ciones|betrayal
traidor/dora|treacherous
trailer|trailer
traje|dress
trajinar|to rush
trama|plot
tramitar|to negotiate
trámite|procedure
tramo|section
trampa|trap
trampear|to cheat
trampilla|hatch
trampolí\lines|diving board
tramposo/a|crooked
trance|critical moment
tranquilo/a|calm
tranquilidad|tranquillity
tranquilizante|tranquilizer
tranquilizar|to calm
tranquilizarse|to calm down
transacción\ciones|transaction
transatlántico/a|transatlantic
transbordador|ferry
transbodar|to transfer
transcribir|to transcribe
transcripción\ciones|transcription
transcurrir|to pass
transcurso|course
transeúnte|passerby
transferir|to transfer
transferencia|transference
transformar|to transform
transformarse|to be transformed
transformación\ciones|transformation
transformador|transformer
transfusión\siones|transfusion
transgredir|to transgress
transgresión\siones|transgression
transción\ciones|transition
transistor|transistor
transitar|to go
transitable|passable
transitivo/a|transitive
tránsito|transit
transitorio/ria|transitory
transmitir|to transmit
transmisión\siones|transmission
transmisor|transmitter
transparente|transparent
transpirar|to sweat
transpiración\ciones|sweating
transportar|to transport
transportarse|to be transported
transporte|transport
tranvía|streetcar
trapear|to mop
trapecio|trapeze
trapo|rag
tráquea|trachea
tras|after
trascendencial|importnace
trascendental|transcendental
trasero/a|buttock
trasfondo|background
trasladar|to transfer
trasladarse|to be transferred
traslado|transfer
traslucirse|to be translucent
traslúcido/a|translucent
trasnochar|to stay up all nigth
trasplantar|to transplant
trasplante|transplant
trasquilar|to shear
traste|fret
trastos|pieces of junk
trastornar|to disturb
trastornarse|to go crazy
trastornado/a|disturbed
trastorno|disturbance
trastrocar|to change
tratable|treatable
tratar|to try
tratado|treatise
tratamiento|treatment
trato|treatment
trauma|trauma
traumático/a|traumatic
través|through
travesía|voyage
travesura|prank
travieso/a|naughty
trayecto|path
trazado|sketch
trazar|to trace
trazo|outline
trébol|clover
trece|thirteen
treceavo/a|thirteenth
trecho|stretch
tregua|truce
treinta|thirty
tremendo/a|tremendous
trémulo/a|tremulous
tren|train
trenza|braid
trepar|to climb
treparse|to climb
trepador/dora|climbing
tres|three
trescientos/tas|three hundred
treta|trick
triángulo|triangle
triangular|triangular
tribu|tribe
tribulación\ciones|tribulation
tribuna|tribune
tribunal|court
tributar|to pay
tributo|tribute
triciclo|tricycle
tricolor|tricolored
tridimensional|three-dimensional
trigésimo/a|thirtieth
trigo|wheat
trigometría|tigonometry
trillar|to thresh
trillizo/a|triplet
trilogía|trilogy
trimestral|quarterly
trinchera|trench
trineo|sleigh
trinidad|trinity
trino|trill
trío|trio
tripa|gut
triple|triple
trípode|tripod
tripulación\ciones|crew
tripulante|crew member
triste|sad
tristeza|sadness
triturar|to crush
triunfar|to win
triunfal|triumphal
triunfante|triumphant
triunfo|vistory
trivial|trivial
trocha|path, trail
trofeo|trophy
trombón\bones|trombone
trombosis|thrombosis
trompa|trunk
trompeta|trumpet
trompetista|trumpet player
trompo|top (toy)
tronada|thunderstorm
tronar|to thunder
tronchar|to snap
tronco|trunk
trono|throne
tropa|troops
tropezar|to stumble
tropezón\zones|stumble
trópico|tropic
tropical|tropical
tropiezo|slip
trotar|to trot
trote|trot
trozo|piece
trucha|trout
truco|trick
trueno|thunder
trueque|exchange
truncar|to thwart
tu|your, you
tuba|tuba
tuberculosis|tuberculosis
tubo|tube
tubería|pipes
tuerca|nut
tuerto/a|one-eyed
tuétano|marrow
tufo|vapor, stink
tulipán\panes|tulip
tumba|tomb
tumbar|to knock down
tumor|tumor
tuna|prickly pear
túnel|tunnel
túnica|tunic
tupido/a|dense
turba|peat
turbación\ciones|confusion
turbante|turban
turbar|to disturb
turbina|turbine
turbio/bia|cloudy
turbulencia|turbulence
turbulento/a|turbulent
turco/a|turkish
turista|tourist
turismo|tourism
turístico/a|tourist
turnarse|to take turns
turno|turn
turquesa|turquoise
turrón\rrones|turrón
tutor/tora|tutor
tuyo\ya|yours
u|or
ubicar|to locate
ubicarse|to be located
ubre|udder
ufano/a|proud
ujier|to usher
úlcera|ulcer
últimamente|lately
ultimar|to complete
ultimátum\tums|ultimatum
último/a|last
ultrajar|to outrage
ultramar|overseas
ultramarino/a|overseas
ultrasonido|ultrasound
ultravioleta|ultraviolet
umbilical|umbilical
umbral|threshold
un/una|a, an
unánime|unanimous
undécimo/a|eleventh
ungir|to anoint
único/a|only
únicamente|only
unicornio|unicorn
unidad|unit
unido/a|united
unificar|to unify
unificación\ciones|unification
uniformar|to uniform
uniformado/a|uniformed
uniforme|uniform
uniformidad|uniformity
unilateral|unilateral
unir|to unite
unirse|to join
unión\niones|union
unísono|in unison
unitario/ria|unitary
universal|universal
universidad|university
universitario/ria|university, college student
universo|universe
uno/una|one
untar|to grease
uña|nail
uranio|uranium
urano|uranus
urbano/a|urban
urbanidad|politeness
urbanización\ciones|urbanization
urbanizar|to urbanize
urgir|to be urgent
urgencia|urgency
urgente|urgent
urinario/ria|toilet
urraca|magpie
uruguayo/a|Uruguayan
usar|to use
usarse|to be used
usado/a|used
usted|you
usual|usual
usuario/ria|user
usurpar|to usurp
utensilio|utensil
útero|uterus
utilizar|to use
útil|useful
útiles|implements, tools
utilidad|utility
utilitario/ria|utilitarian
utilización\ciones|use
uva|grape
vaca|cow
vacaciones|vacations
vacante|vacancy
vaciar|to drain
vacilar|to vacillate
vacilación\ciones|hesitation
vacilante|vacillating
vacío/cía|empty
vacuna|vaccine
vacunación\ciones|vaccination
vacunar|to vaccinate
vacuno/a|bovine
vagabundear|to wander
vagabundo/a|vagrant
vagancia|vagrancy
vagar|to roam
vagina|vagina
vago/a|vague
vagón\gones|wagon
vaina|sheat
vainilla|vanilla
vaivén\venes|swing
vajilla|set of dishes
vale|voucher
valedero/a|valid
valentía|courage
valer|to be worth
valeroso/a|courage
validar|to validate
valiente|brave
valija|valise, case
valioso/a|valuable
valle|valley
valor|value
válvula|valve
vampiro|vampire
vanagloriarse|to boast
vándalo|vandal
vandalismo|vandalism
vanguardia|vanguard
vanidad|vanity
vanidoso/a|vain person
vano/a|vain
vapor|steam
vaporizador|vaporizer
vaporizar|to vaporize
vaquero/a|cowboy
vaqueros|cattle tenders
vara|stick
varado/a|stranded
variar|to vary
variable|variable
variación\ciones|variation
variado/a|varied
variante|variant
varicela|chicken pox
variedad|variety
varilla|rod
varón\rones|man\male
vasco/a|basque
vasija|container
vaso|glass
vecinal|local
vecino/a|neighbor
vecindad|neighborhood
vecindario|neighborhood
vedar|to forbid
vegetal|vegetable
vegetación\ciones|vegetation
vegetar|to vegetate
vegetariano/a|vegetarian
vehemente|vehement
vehículo|vehicle
veinte|twenty
veinteavo/a|veinteavo
veintena|twenty
vejez|oldness
vejiga|bladder
vela|candle
velar|to guard
velero|sailboat
vello|hair
velludo/a|hairy
velo|veil
veloz\loces|quick
velocidad|speed
velocímetro|speedometer
vena|vein
venado|deer
vencer|to win
vencedor/dora|winner
vencido/a|beaten
vencimiento|expiration
venta|sale
vendaje|bandage
vendar|to bandage
vender|to sell
venderse|to be sold
vendedor/dora|salesman
vendimia|grape harvest
veneno|poison
venenoso/a|poisonous
venerar|to venerate
venerable|venerable
veneración\ciones|veneration
venéreo/rea|venereal
venezolano/a|venezuelan
vengar|to avenge
vengarse|to take revenge
venganza|revenge
vengativo/a|vindictive
venial|venial
venir|to come
venida|coming
venidero/a|successor
venta|sale
ventaja|advantage
ventajoso/a|advantageous
ventana|window
ventanilla|window
ventilar|to ventilate
ventilación\ciones|ventilation
ventilador|ventilator, fan
ventisca|blizzard
ventoso/a|windy
ventrílocuo/cua|ventriloquist
ventura|fortune
venturoso/a|fortune
ver|to see
veracidad|veracity
verano|summer
veranear|to spend the summer
veraniego/a|summery
veras|really
veraz|truthful
verbal|verbal
verbena|festival
verbo|verb
verdad|truth
verdaderamente|truely
verdadero/a|true
verde|green
verdugo|twig
verdura|vegetable
vereda|path
veredicto|verdict
verguenza|shame
vergonzoso/a|shameful
verídico/a|verídico
verificar|to verify
verificación\ciones|verification
verosímil|likely
versátil|versatile
versión\siones|version
vértebra|vertebra
vertical|vertical
vértice|vertex
vértigo|vertigo
vesícula|blister
vestíbulo|vestibule
vestido|dress
vestigio|vestige
vestir|to dress
vestirse|to get dressed
vestimenta|clothes
vestuario|clothes
vetar|to veto
veterano/a|veteran
veterinaria|veterinary medicine
veterinario/ria|veterinarian
vez\veces|time
vía|via
viable|viable
viabilidad|viability
viajar|to travel
viajante|traveler
viaje|travel
viajero/a|traveller
víbora|viper
vibrar|to vibrate
vibración\ciones|vibration
vibrante|vibrant
vicepresidente/a|vice-president
viceversa|vice versa
vicio|vice
viciado/a|vitiated
viciar|to vitiate
vicioso/a|vicious person
vicisitud|vicissitude
víctima|victim
victoria|victory
victorioso/a|victorious
vid|grapevine
vida|life
video|video
vidrio|glass
vidriera|show window
vidrioso/a|delicate
viejo/a|old
viento|wind
vientre|belly
viernes|friday
vietnamita|Vietnamese
viga|beam
vigencia|validity
vigésimo/a|twentieth
vigilar|to watch
vigilancia|vigilance
vigilante|watchman
vigorizante|invigorating
vigoroso/a|vigorous
vih|hiv
vil|vile
vileza|vileness
villa|village
villancico|carol
villano/a|villain
vinagre|vinegar
vinagreta|vinaigrette
vincular|to tie
vindicar|to vindicate
vino|wine
viña|vineyard
viola|viola
violar|to violate, to rape
violación\ciones|violation, rape
violencia|violence
violentar|to force
violentarse|to force
violeta|violet
violín\lines|violin
violinista|violinist
violonchelista|cellist
violonchelo|cello
virar|to turn
virgen\vírgenes|virgin
virginal|virginal
virginidad|virginity
viril|virile
virilidad|virility
virtual|virtual
virtud|virtue
virtuoso/a|virtuoso
viruela|smallpox
virulento/a|virulent
virus|virus
visa|visa
visado|visa
vísceras|entrails
viscoso/a|viscous
visera|visor
visible|visible
visión\siones|vision
visitar|to visit
vislumbrar|to glimpse
vislumbre|glimpse
víspera|eve
vista|vision
visto/a|sight
vistoso/a|showy
visual|visual
visualizar|to visualize
vital|vital
vitalidad|vitality
vitamina|vitamin
vitrina|display case
vituperar|to censure
vituperio|censure
viudo/a|widower
vivacidad|vivacity
vivaz\vaces|lively
víveres|food
vivero|hatchery
viveza|liveliness
vividor/dora|freeloader
vivienda|house
viviente|living
vivificar|to vivify
vivir|to live
vivo/a|alive
vocablo|word
vocabulario|vocabulary
vocación\ciones|vocation
vocacional|vocational
vocal|vowel
vocalista|singer
vocear|to shout
vocerío|shouting
vociferar|to vociferate
vodka|vodka
volar|to fly
volador/dora|flying
volante|steering wheel
volátil|volatile
volcán/canes|volcano
volcánico/a|volcanic
volcar|to upset
volcarse|overturn
voleibol|volleyball
voltaje|voltage
voltear|to turn over
voltearse|to turn
voltereta|somersault
voltio|volt
voluble|fickle
volumen\lúmenes|volume
voluminoso/a|voluminous
voluntad|will
voluntario/ria|volunteer
voluntarioso/a|willing
voluptuoso/a|voluptuous
volver|to return
volverse|to turn, to become
vomitar|to vomit
voraz\races|voracious
vos|you
vosotros/tras|you
votar|to vote
votación\ciones|voting
votante|voter
voz\voces|voice
vuelo|flight
vuelta|return
vuestro/tra|your
vulgar|vulgar
vulgaridad|vulgarity
vulnerable|vulnerable
vulnerabilidad|vulnerability
wáter|toilet
whisky|whiskey
y|and
ya|already
yacimiento|deposit
yanqui|Yankee
yate|yacht
yegua|mare
yelmo|helmet
yema|yolk
yerno|son-in-law
yesca|tinder
yeso|gypsum, plaster
yo|I
yodo|iodine
yoga|yoga
yogurt|yogurt
yuca|yucca
yugo|yoke
yugoslavo/a|Yugoslavian
yugular|jugular
yunque|anvil
yunta|yoke
zafiro|sapphire
zalamería|flattery
zalamero/a|flatterer
zambullirse|plunge, dive
zambullida|plunge, dive
zanahoria|carrot
zancos|stilts
zancudo|mosquito
zángano/a|lazy person
zapallo|pumpkin
zapato|shoe
zapatería|shoe store
zapatero/a|shoemaker, cobbler
zapatilla|sneaker
zarandear|to shake vigorously
zarcillo|earring
zarpa|paw
zarpar|to set sail
zarza|bramble
zigzag|zigzag
zinc|zinc
zócalo|base
zodíaco|zodiac
zona|zone
zoo|zoo
zoología|zoology
zoológico/a|zoological
zoólogo/a|zoologist
zopilote|buzzard
zoquete|chunk
zorrillo|skunk
zorro/rra|fox
zozobra|anxiety
zozobrar|to sink
zueco|clog (shoe)
zumbar|to buzz
zumbido|buzzing
zumo|juice
zurcir|to mend
zurdo/a|left-handed person
es|it is
del|of, from
una|a, an, one
lo|the, for, it
con|with
al|to, to the
e|and
ha|has been
sus|theirs
esta|is
son|are
da|he gives, she gives
nos|we
puede|can
está|is
me|me
le|it
cultura|culture
esa|that
había|there was
han|have been
tiene|they have
otros|other (plural)
cada|each
otra|other(singular, feminine)
hay|there is, there are
sí|yes
cosas|things
fue|was
todas|all
hace|do
sido|been
toda|all
sea|am
cuanto|how much, as
caso|case
existencia|existence
hombres|men
notas|grades, notes
humana|human(fem)
nuestra|our(fem)
otras|other(fem)
forma|shape
propia|own(fem
formalmente|seriousness
latina|latin(fem)
debe|lend, should, must
conocimiento|knowlogde
esencial|esential
pensamiento|though
trabajo|job
estados|estates
transcendental|transcendental
trata|he tries, she tries
precisamente|precisely
sin embargo| neverthless
primer|first
europa|europe
españa|spain
principios|principles, values
fines|purpose
límite|limit
respecto|in this respect
intelectual|inctelectual
nacional|national
formas|shape(pl)
les|to them
primera|first (fem)
están|they are
hemos|have, as in have been
unidos|united
sería|would be
nuestros|our(pl)
países|countries
posible|posible
cultural|cultural
gran|big
parece|seem
ésta|is
crítica|critic
futuro|future
dice|say, tell
queda|still there is
aparece|appear
efecto|efect
estas|you are
ellas|they
pasado|past
consiste|about, means
quiere|wants
será|will be
pueden|they can
alguna|some(fem)
cualquier|any
cambio|change
entenderse|undestand yourself
he|has, as in has been
aquella|that
razas|races
muchas veces| many times
va|he goes
siendo|it is
mera|similar
mis|my
poeta|poet
estaba|was
à|to
cuales|what, which (pl)
tienen|they have
buen|good, well
algún|some, any
perder|to lose, miss
único|only, unique
político|political
para que|so that
incluso|even, in fact
resultar|to turn out, work out, succeed
después de|after
gobierno|government
millón|million
partido|party, game
nombre|name
largo|long
paso|step
importante|important
pueblo|town
antes de|before
número|number
distinto|different
necesitar|to need
por ejemplo|for example
ahí|there
estudio|study, studio
resultado|result, outcome
alguien|somebody, someone
económico|economic, economical
apenas|hardly,scarcely
mirada|watched
ya que|since
ningún|none
señalar|to indicate, point out
centro|center, downtown
personal|personal
bastante|fairly, rather
hasta que|until, even
acercar|to approach
diferente|different
dentro de|within, in
faltar|to lack
enfermedad|illness, disease, sickness
espacio|space
extraño|strange, foreign
ni siquiera|not even
suelo|ground, floor
lleno|full
marido|husband
junto a|next to
a través de|through, across
es decir|that is to say
sino que|but that
tercer|third
físico|physical, physicist
completo|complete, full
miembro|member
española|Spanish, spaniard
hija|daughter
opinión|opinion
directo|direct, straight
tal vez|perhaps
personaje|person
definitivo|definitive
grave|grave, deep
niña|girl, child
esfuerzo|effort, endeavor, exertion
objetivo|objective
instante|moment, instant
barcelona|barcelona
operación|operation
comentar|to comment, discuss, mention
causa|cause, reason
colocar|to place, put
diverso|diverse
interesar|to interest
serio|serious
con que|so long as
dedo|finger, toe
bastar|to be enough, suffice
normal|normal
varias|several
dolor|pain
habitación|room, bedroom
enfermo|ill, sick
modelo|model
pleno|full, complete
importar|to matter, be important
así como|as well as, such, like that
material|material
advertir|to notice, warn
paciente|patient
histórico|historical
fijar|to faten, affix
jugador|player, gambler
expresión|expression
figura|figure, shape
rodear|to surround, encircle
práctico|practical
base|base, basis
chica|small, girl,litlle
marcha|march
caber|to fit, go into
defensa|defense
uso|use
familiar|familial, family
contrario|opposite
pierna|leg
ayuda|aid, help
conversación|conversation
lucha|fight, struggle
concreto|concrete, specific
arma|weapon
pareja|even, couple, pair
cabo|end, stub
extremo|extreme
fundamental|fundamental
estados unidos| united States
notar|to notice
salida|exit, departure
periodista|journalist
desconocer|to not know, fail to recognize
sentimiento|feeling
distancia|distance
esperanza|hope, prospect
mientras que|whereas, while
control|control, check
mundial|worldwide
gusto|taste, pleasure, liking
masa|mass
evidente|evident
semejante|similar
abuelo|grandfathers, grandpa
dificultad|difficulty
habitual|habitual, usual
francia|france
tono|tone
perfecto|perfect
ejército|army
destino|destiny, destination
individuo|individual
además de|in addition to, besides, furthermore
lento|slow
famoso|famous
hermana|sister
fútbol|soccer, football
introducir|to introduce, insert
doble|double
a partir de|from, as of
varios|several
tía|aunt
fuera de|outside of, beyond
contacto|contact
radio|radio
desde que|since
informar|to inform
menudo|small, insignificant
constante|constant
catalán|catalan
junto|together, joined, close
negocio|business
así que|so, therefore
declaración|declaration, statement
edificio|building
grado|degree
por supuesto|of course
cargar|to load, hold on, carry
un poco|a little
escaso|scarce, scanty
citar|to mention, cite, make an appointment
complejo|complex
enfrentar|to face, confront
peligroso|dangerous
visita|visits
factor|factor
grito|shout, scream
esposa|wife
distinguir|to distinguish
oposición|opposition
banco|bank, bench
muchacha|girl
encargar|to order, entrust, charge
franco|frank, franc
contenido|restrained, contents
ligero|light, slight
literario|literary
numeroso|numerous
interno|internal
sujeto|subject
no obstante|nevertheless, however, despite
denominar|to denominate
esconder|to hide, conceal
proporcionar|to provide
gracias a|thanks to
cerca de|near, close, fence
a pesar de|in spite of
característica|characteristic
explicación|explanation
apoyo|support
vario|varied
amiga|friend
recurso|resource
crítico|critical, critic, reviewer
basar|to base
curioso|curious, inquisitive
ejercicio|exercise, practice
abuela|grandmother, grandma
detalle|detail
más o menos|more or less
llamada|call
carecer|to lack
electoral|electoral
a lo largo de|throughout, lengthwise
más bien|rather
referencia|reference
lógico|logical
cuidado|care
lectura|reading
juventud|youth
a punto de|on the verge of
perfectamente|perfectly
falso|false, untrue
frecuente|frequent
intervención|intervention
desde luego|of course
nervioso|nervous
asomar|to show, stick out
desnudo|naked, nude
formación|formation, training
pese a|in spite of, despite
construcción|construction, building
convenir|to be suitable, agree on
devolver|to give back, refund, pay back
barco|boat, ship
muerto|died
montaña|mountain
cercano|near, close
por lo menos|at least
despacho|office, dispatch
químico|chemical
colectivo|collective
dudar|to doubt
parís|paris
intento|intention
llegada|arrival
tradición|tradition
pérdida|loss, leak
quizás|maybe, perhaps
guardia|guard, vigilence
a la vez|simultaneously, at the same time
puesto que|since, given that
posterior|later
confianza|confidence, trust
constitución|constitution
básico|basic
radical|radical
voto|vote
mía|mine
brillante|shining
firmar|to sign
consumo|consumption
ambas|both
ausencia|absence
excesivo|excessive
identificar|to identify
callar|to shut up, be silent
eléctrico|electrical, electric
gonzález|gonzález
bello|beautiful, nice, pretty
educación|education, manners
especialista|specialist
maestro|masterly, teacher
genético|genetic
remedio|remedy
comunista|communist
industrial|industrialist, industrial
mero|mere, simple
partida|departure, divided
habitante|inhabitant, resident
investigador|investigator, researcher
negativo|negative
exclusivo|exclusive
de modo que|so that
aventura|adventure
batalla|battle, fight, struggle
personalidad|personality
actuación|performance
concentración|concentration
infinito|infinite
laboratorio|laboratory, lab
intenso|intense
argumento|argument
destruir|to destroy, dismiss
poderoso|powerful
estrecho|narrow, tight, close
paisaje|landscape
punto de vista|point of view
parlamentario|parliamentary
trabajador|worker
gasto|expense
oído|ear
sabio|wise
documento|document
gen|gene
en cuanto a|as far as, with regard to
manifestación|manifestation
cuento|story, tale
en torno a|around, about
permanente|permanent
comentario|commentary, comment, remark
ilusión|illusion
baño|bath,bathroom, toilet
imaginación|imagination
occidental|western
poesía|poetry
bolsillo|pocket
impulso|impulse
por encima de|over
vaya|goes
interesante|interesting
específico|specific
fracaso|failure
descubrimiento|discovery
escenario|scene, stag
poco a poco|little by little
por el contrario|on the contrary
aparente|apparent, seeming
postura|position, stance
biológico|biological
consciente|conscious
jornada|day's journey, working day
deportivo|sporty
en medio de|in the middle of
incapaz|incapable
izquierdo|left
beneficio|benefit
violento|violent
dentro del|within
lejos de|far from
daño|damage, harm
equilibrio|balance, equilibrium
inicial|initial
mando|control, command, leadership
asimismo|also, likewise
funcionario|civil employee
algo de|something of, some
detrás de|behind, in back of
golpear|to strike, hit
derivar|to derive, drift
fiel|faithful, loyal
mentira|lie
acerca de|about
facilitar|to facilitate, provide, supply
fijo|fixed, firm
limpio|clean, neat
notable|notable
empleo|use, employment, job
alguna vez|sometimes
en lugar de|instead of
espectador|spectator, onlooker
circular|to circulate, drive
diciendo|saying
banda|band
nuclear|nuclear
junto al|next to
digno|worthy
apariencia|appearance, look
crecimiento|growth, increase
decisivo|decisive
artístico|artistic
delicado|delicate
hogar|home
estudiante|student
papá|dad
pendiente|pending
medicina|medicine
oscuridad|dark
aproximar|to approximate
compromiso|commitment, obligation, engagement, agreement
italia|Italy
alcance|reach
eficacia|effectiveness, efficiency
quejar|to complain
representante|representative
transición|transition
curiosidad|curiosity
vas|you go
consideración|consideration
de pronto|suddenly
participación|participation
alrededor de|around, approximately
en seguida|immediately, at once, right away
escala|scale
competencia|competition, competence
aplicación|application
comercial|commercial
en vez de|instead of
fruto|fruit, consequence
infantil|child's
correspondiente|corresponding, respective
debate|debate
alemania|germany
dorar|to gild, brown
parlamento|parliament
asociación|association
paro|stoppage, shutdown
señorita|young lady, miss
tal como|as
múltiple|multiple
iniciativa|initiative
desplazar|to move, displace
después del|after
húmedo|humid, moist
precisión|precision
ceder|to yield, give way
misterioso|mysterious
por favor|please
psicológico|psychological
diálogo|dialogue
llamado|called, named
reservar|to reserve, keep, save
financiero|financial, financier
ideológico|ideological
obligación|obligation
ingreso|entrance, entry
nacimiento|birth
mezclar|to mix, blend
en todo caso|in any case
caracterizar|to characterize
diputado|delegated
emisor|emitter
humanidad|humanity
ético|ethical
imperio|empire